Date,Department,Hospital Region,Patients Billed,Charges,Operating Costs,Insurance Discount,Supply Cost,Tax,Net Profit,Gross Profit
2022-01-01,Urology,Los Angeles,202,13017,11167,1788.83,6469,1263,1850,6548
2022-01-02,Radiology,Sydney,535,11941,8586,1186.39,6121,671,3355,5820
2022-01-03,Cardiology,Houston,960,30934,25579,3719.07,9357,2900,5355,21577
2022-01-04,Gastroenterology,Seoul,370,28386,19328,4237.51,10369,2797,9058,18017
2022-01-05,Orthopedics,Toronto,206,15209,11519,960.43,7581,895,3690,7628
2022-01-06,Pediatrics,London,171,22715,16140,1759.8,10112,1955,6575,12603
2022-01-07,Pediatrics,Chicago,800,33920,26886,3034.4,10230,1764,7034,23690
2022-01-08,Oncology,Sydney,120,36703,19549,3383.39,19869,2579,17154,16834
2022-01-09,Gastroenterology,Sydney,714,47318,24801,4310.77,25165,3587,22517,22153
2022-01-10,Radiology,Los Angeles,221,9637,5771,1356.51,4476,761,3866,5161
2022-01-11,Urology,Chicago,566,9854,5555,1196.31,3152,953,4299,6702
2022-01-12,Gastroenterology,Toronto,314,48088,40812,5327.69,25484,4020,7276,22604
2022-01-13,Ophthalmology,Los Angeles,430,42660,25070,3452.78,20268,3159,17590,22392
2022-01-14,Dermatology,Sydney,558,44811,39897,5932.04,23955,4054,4914,20856
2022-01-15,Radiology,New York,187,24856,15777,3616.7,13062,2424,9079,11794
2022-01-16,Neurology,Toronto,472,26833,15371,3545.17,14513,1371,11462,12320
2022-01-17,Emergency,Sydney,199,24963,20366,1252.06,11368,2474,4597,13595
2022-01-18,Cardiology,Tokyo,971,41932,32014,4765.16,14344,2277,9918,27588
2022-01-19,Cardiology,Tokyo,763,32169,22495,1772.95,16127,2918,9674,16042
2022-01-20,Radiology,Houston,230,12941,9345,980.42,6291,828,3596,6650
2022-01-21,Pediatrics,Los Angeles,761,19388,15271,1084.81,10133,1097,4117,9255
2022-01-22,Pediatrics,Sydney,408,10569,6250,1166.6,3709,760,4319,6860
2022-01-23,Dermatology,Houston,869,9300,8356,1103.53,3333,764,944,5967
2022-01-24,Neurology,Los Angeles,443,44037,39189,2706.02,24974,3040,4848,19063
2022-01-25,Cardiology,Toronto,591,41586,31610,3675.53,21832,2192,9976,19754
2022-01-26,Dermatology,Sydney,513,17015,9865,1627.04,9740,1360,7150,7275
2022-01-27,Pediatrics,Los Angeles,905,11254,8689,978.03,5937,1070,2565,5317
2022-01-28,Gastroenterology,Sydney,485,22144,11711,1375.2,10610,1531,10433,11534
2022-01-29,Urology,New York,291,29214,14965,2684.61,14497,1776,14249,14717
2022-01-30,Gastroenterology,London,376,45118,27209,5645.07,25570,3254,17909,19548
2022-01-31,Dermatology,Berlin,260,20183,13826,1152.46,9559,1057,6357,10624
2022-02-01,Emergency,Tokyo,559,11238,9522,652.01,5503,1022,1716,5735
2022-02-02,Pediatrics,London,413,11090,8770,947.94,3847,1012,2320,7243
2022-02-03,Pathology,Los Angeles,121,16637,13261,2398.6,7356,1320,3376,9281
2022-02-04,Neurology,Berlin,352,27415,18373,3203.64,14116,1854,9042,13299
2022-02-05,Orthopedics,London,847,29071,18558,3426.51,11084,2616,10513,17987
2022-02-06,Endocrinology,New York,956,47679,30915,4109.55,17196,3706,16764,30483
2022-02-07,Psychiatry,Tokyo,660,46240,41387,5057.09,18225,4221,4853,28015
2022-02-08,Cardiology,Seoul,574,23271,12008,1187.13,8667,1898,11263,14604
2022-02-09,Endocrinology,Los Angeles,158,41034,34748,4661.86,14955,3661,6286,26079
2022-02-10,Endocrinology,Tokyo,610,38434,28113,5431.83,16428,3071,10321,22006
2022-02-11,Oncology,London,781,9188,6205,1022.23,5258,649,2983,3930
2022-02-12,Gastroenterology,Seoul,575,15161,11978,2082.66,6854,1484,3183,8307
2022-02-13,Emergency,Chicago,799,33732,23432,4128.71,12021,2599,10300,21711
2022-02-14,General Surgery,Tokyo,882,16314,13856,1012.38,5270,1309,2458,11044
2022-02-15,Orthopedics,Chicago,289,28954,24908,4060.66,14733,1766,4046,14221
2022-02-16,Oncology,Berlin,786,26508,17725,1501.53,10996,2154,8783,15512
2022-02-17,Pediatrics,Toronto,662,26969,16470,2788.51,14739,2119,10499,12230
2022-02-18,Endocrinology,Sydney,975,42545,31353,2731.97,21181,2520,11192,21364
2022-02-19,General Surgery,Berlin,666,41668,36040,2132.18,22453,2207,5628,19215
2022-02-20,Radiology,Seoul,343,28061,16395,2587.32,10707,2250,11666,17354
2022-02-21,Radiology,Seoul,931,18716,14021,1488.0,9502,1650,4695,9214
2022-02-22,Emergency,Tokyo,604,44749,33679,4412.25,16969,3408,11070,27780
2022-02-23,Radiology,Sydney,230,44144,35017,4755.19,25679,2707,9127,18465
2022-02-24,General Surgery,Toronto,584,21907,12106,1191.17,10754,1825,9801,11153
2022-02-25,Psychiatry,London,918,23777,18696,1481.31,9447,1284,5081,14330
2022-02-26,General Surgery,Houston,746,32693,28234,3461.02,12451,2356,4459,20242
2022-02-27,Neurology,Los Angeles,120,47928,27408,4041.13,17123,2787,20520,30805
2022-02-28,Orthopedics,Toronto,940,31329,18641,3850.88,15927,1855,12688,15402
2022-03-01,Endocrinology,Seoul,266,21282,18910,2452.31,7781,1279,2372,13501
2022-03-02,Cardiology,Houston,373,28624,16384,3851.66,13699,1984,12240,14925
2022-03-03,Gastroenterology,Seoul,487,28321,23839,3377.26,10744,1488,4482,17577
2022-03-04,Pathology,Sydney,700,15488,10793,1440.28,7722,1082,4695,7766
2022-03-05,Dermatology,Sydney,415,27574,16513,3234.34,15013,2084,11061,12561
2022-03-06,Radiology,Tokyo,113,10240,8686,793.99,5462,759,1554,4778
2022-03-07,Ophthalmology,London,341,48221,32699,3888.12,25473,3333,15522,22748
2022-03-08,Emergency,New York,876,15478,10926,1995.09,5515,1423,4552,9963
2022-03-09,Radiology,Seoul,445,24262,15617,2296.2,7921,1389,8645,16341
2022-03-10,Dermatology,London,664,9432,6953,1224.63,4807,710,2479,4625
2022-03-11,Orthopedics,Chicago,997,34721,19631,4591.58,14253,1843,15090,20468
2022-03-12,Psychiatry,Seoul,439,18568,12188,2520.72,7978,994,6380,10590
2022-03-13,Urology,Houston,191,19178,17025,2716.82,5932,1509,2153,13246
2022-03-14,Neurology,London,466,27195,16405,2531.81,10276,2129,10790,16919
2022-03-15,Ophthalmology,Toronto,554,5302,4043,434.16,1644,497,1259,3658
2022-03-16,Psychiatry,London,527,22022,13875,2383.22,12415,1715,8147,9607
2022-03-17,General Surgery,Toronto,608,5055,4091,440.38,1885,495,964,3170
2022-03-18,Neurology,Sydney,875,13717,7576,1510.34,6408,719,6141,7309
2022-03-19,Pediatrics,Toronto,134,33699,29922,4062.7,10503,1850,3777,23196
2022-03-20,Gastroenterology,Berlin,305,13150,8961,1562.75,6575,686,4189,6575
2022-03-21,Radiology,New York,180,7125,4235,623.12,2827,422,2890,4298
2022-03-22,Cardiology,Berlin,661,49247,26071,3284.09,28040,3795,23176,21207
2022-03-23,Urology,Houston,971,21748,12350,2023.72,12318,1789,9398,9430
2022-03-24,Pediatrics,Los Angeles,487,44577,31556,2864.49,17723,2330,13021,26854
2022-03-25,Endocrinology,Houston,101,9621,6107,1337.41,5486,936,3514,4135
2022-03-26,Orthopedics,Tokyo,489,20034,16659,1694.63,11997,1845,3375,8037
2022-03-27,Radiology,Seoul,665,10126,6808,662.71,5545,656,3318,4581
2022-03-28,Psychiatry,Berlin,205,10122,6067,531.86,5602,545,4055,4520
2022-03-29,Pediatrics,Houston,871,23030,17200,2638.83,8629,1347,5830,14401
2022-03-30,Psychiatry,Seoul,921,22302,17456,2535.52,10549,1256,4846,11753
2022-03-31,Radiology,Seoul,576,24181,13706,2032.66,7742,1358,10475,16439
2022-04-01,Emergency,Seoul,802,43638,24744,2494.84,14334,3313,18894,29304
2022-04-02,Orthopedics,New York,501,6531,3361,594.08,3916,406,3170,2615
2022-04-03,Pathology,Los Angeles,829,45940,36502,3726.73,18283,3119,9438,27657
2022-04-04,Urology,Toronto,655,45441,34786,5348.95,23831,4520,10655,21610
2022-04-05,Psychiatry,Houston,261,28333,19545,3133.0,15356,2386,8788,12977
2022-04-06,General Surgery,Tokyo,301,44650,37401,3860.41,24888,4351,7249,19762
2022-04-07,Oncology,Houston,369,39674,32622,2848.17,23776,2266,7052,15898
2022-04-08,General Surgery,Toronto,962,40854,29992,6079.22,15216,2823,10862,25638
2022-04-09,General Surgery,Sydney,915,13152,11143,1254.7,4104,1022,2009,9048
2022-04-10,Pediatrics,London,370,43518,25342,5171.13,18423,2342,18176,25095
2022-04-11,Urology,Seoul,555,15267,8316,977.93,5175,766,6951,10092
2022-04-12,Orthopedics,Berlin,561,30289,18412,2985.25,9290,2529,11877,20999
2022-04-13,Gastroenterology,Berlin,826,6062,3169,319.79,2474,497,2893,3588
2022-04-14,Ophthalmology,London,351,34926,24883,3511.65,18689,2463,10043,16237
2022-04-15,Urology,Tokyo,801,11229,9821,1643.95,5275,836,1408,5954
2022-04-16,Urology,Berlin,395,9632,4967,851.67,3793,681,4665,5839
2022-04-17,Radiology,London,824,44056,24179,2374.6,21865,2255,19877,22191
2022-04-18,Neurology,London,819,8596,5852,456.41,3177,573,2744,5419
2022-04-19,Urology,Seoul,848,49243,43016,4372.71,14985,2898,6227,34258
2022-04-20,Oncology,Toronto,437,11168,6996,737.12,5911,613,4172,5257
2022-04-21,Dermatology,Toronto,978,47563,33431,2489.22,23169,4653,14132,24394
2022-04-22,Gastroenterology,Toronto,152,12561,6489,1577.93,6640,1004,6072,5921
2022-04-23,Pediatrics,Houston,891,13258,7415,1270.81,4132,1145,5843,9126
2022-04-24,Oncology,Los Angeles,316,21616,19338,1706.03,11913,1421,2278,9703
2022-04-25,Pathology,Houston,863,31734,28117,4443.02,15418,2210,3617,16316
2022-04-26,Emergency,London,287,11371,5707,700.61,5333,703,5664,6038
2022-04-27,Orthopedics,Los Angeles,479,31069,27363,4523.39,15142,1704,3706,15927
2022-04-28,Ophthalmology,Berlin,592,19369,14636,1576.57,10833,1141,4733,8536
2022-04-29,Urology,Chicago,140,17910,15172,2486.63,8526,1609,2738,9384
2022-04-30,Gastroenterology,Houston,256,12943,8825,1427.54,6138,1085,4118,6805
2022-05-01,Dermatology,Houston,114,17199,12146,2281.8,10271,1330,5053,6928
2022-05-02,Pediatrics,Seoul,912,20728,14417,3076.06,10924,1528,6311,9804
2022-05-03,Urology,Toronto,164,28275,21679,2229.22,12234,2717,6596,16041
2022-05-04,General Surgery,Sydney,956,11738,6524,1715.08,6012,629,5214,5726
2022-05-05,Psychiatry,Berlin,938,20913,10707,1860.17,8715,1339,10206,12198
2022-05-06,Endocrinology,Sydney,620,40240,25076,3563.3,14834,2716,15164,25406
2022-05-07,Endocrinology,Toronto,443,24123,18861,2027.27,11556,2149,5262,12567
2022-05-08,Cardiology,Los Angeles,228,39529,22956,4116.58,22865,3938,16573,16664
2022-05-09,Pediatrics,Houston,747,15167,11669,992.14,8777,940,3498,6390
2022-05-10,Psychiatry,Toronto,571,15554,13811,1638.94,6261,1457,1743,9293
2022-05-11,Cardiology,Houston,162,22260,11966,2318.83,10201,2037,10294,12059
2022-05-12,Endocrinology,London,238,8812,6776,1111.99,3203,539,2036,5609
2022-05-13,General Surgery,Chicago,598,33024,22373,4404.25,19771,2310,10651,13253
2022-05-14,Emergency,Toronto,692,32285,27353,3036.21,19188,2275,4932,13097
2022-05-15,Orthopedics,New York,491,31900,18210,2559.44,15785,3155,13690,16115
2022-05-16,Radiology,Berlin,774,6605,5132,501.54,3575,389,1473,3030
2022-05-17,Pediatrics,Chicago,518,10622,8871,737.83,5465,955,1751,5157
2022-05-18,Ophthalmology,Toronto,388,11767,10329,656.18,5624,784,1438,6143
2022-05-19,Neurology,New York,478,32139,24853,2707.54,10156,2781,7286,21983
2022-05-20,Ophthalmology,New York,872,16613,11610,1279.61,7250,1179,5003,9363
2022-05-21,Gastroenterology,Berlin,589,15589,11647,2286.0,7832,1230,3942,7757
2022-05-22,General Surgery,Toronto,330,18918,16034,2000.97,9520,1733,2884,9398
2022-05-23,Pediatrics,Chicago,140,25119,18292,2128.28,10347,2265,6827,14772
2022-05-24,Urology,Seoul,127,32446,16617,3505.69,18900,3027,15829,13546
2022-05-25,Pathology,Los Angeles,234,18046,15742,1153.49,6319,956,2304,11727
2022-05-26,Emergency,New York,300,29818,23133,2814.95,13421,2522,6685,16397
2022-05-27,Ophthalmology,Sydney,939,40358,31100,4545.26,20472,2300,9258,19886
2022-05-28,Ophthalmology,Toronto,879,9324,5466,922.05,4747,660,3858,4577
2022-05-29,Urology,Seoul,132,15787,12054,1423.64,7808,1222,3733,7979
2022-05-30,Pathology,Seoul,147,14111,9278,2107.97,5398,989,4833,8713
2022-05-31,Oncology,Seoul,602,43110,32784,5950.54,14953,3275,10326,28157
2022-06-01,Orthopedics,London,506,21389,11606,2402.85,10497,2135,9783,10892
2022-06-02,Oncology,Chicago,673,46427,35430,4964.8,22275,2635,10997,24152
2022-06-03,Pediatrics,New York,827,19043,17134,2134.07,6737,1595,1909,12306
2022-06-04,Gastroenterology,Toronto,904,33746,17523,2366.65,17262,2355,16223,16484
2022-06-05,Dermatology,Seoul,198,27350,24365,2448.2,11939,1549,2985,15411
2022-06-06,Dermatology,Los Angeles,783,46605,30888,2514.15,23317,2700,15717,23288
2022-06-07,Orthopedics,Los Angeles,971,5117,4340,499.19,2820,498,777,2297
2022-06-08,Gastroenterology,Tokyo,825,23935,19458,2496.48,8399,2249,4477,15536
2022-06-09,Neurology,Seoul,646,18234,13252,1326.98,5574,1738,4982,12660
2022-06-10,Emergency,Los Angeles,838,43328,34462,6343.34,23125,4314,8866,20203
2022-06-11,Ophthalmology,Sydney,712,5846,4977,823.97,2823,353,869,3023
2022-06-12,Neurology,New York,561,15954,10556,1949.81,8134,1081,5398,7820
2022-06-13,Emergency,Chicago,742,18703,11798,1932.74,10313,1560,6905,8390
2022-06-14,General Surgery,Chicago,868,27700,21246,3794.81,14981,2055,6454,12719
2022-06-15,Pediatrics,Sydney,104,37043,30491,2336.13,21791,2627,6552,15252
2022-06-16,Oncology,Toronto,317,11469,9231,1480.09,5284,778,2238,6185
2022-06-17,Dermatology,Los Angeles,602,35105,28755,2193.43,15676,2797,6350,19429
2022-06-18,Pathology,Houston,866,47101,31757,6095.86,19809,3710,15344,27292
2022-06-19,Radiology,Los Angeles,497,31386,25960,2434.82,10862,1822,5426,20524
2022-06-20,Endocrinology,Berlin,970,41976,23006,5780.48,19803,3088,18970,22173
2022-06-21,Cardiology,Tokyo,894,44051,31619,6361.15,16876,3421,12432,27175
2022-06-22,Psychiatry,Sydney,492,7048,3540,457.27,4062,553,3508,2986
2022-06-23,Radiology,Sydney,306,44001,27713,4235.87,20898,2662,16288,23103
2022-06-24,Oncology,Sydney,114,17941,11600,2657.04,8573,1562,6341,9368
2022-06-25,Urology,Houston,957,47533,31299,4674.43,19321,2436,16234,28212
2022-06-26,Oncology,Berlin,653,6828,5313,931.03,2154,462,1515,4674
2022-06-27,Endocrinology,Tokyo,991,6917,4533,753.08,2140,615,2384,4777
2022-06-28,Urology,Seoul,560,25618,17406,2242.42,10938,2003,8212,14680
2022-06-29,Emergency,Seoul,790,37254,22166,2927.36,12121,2349,15088,25133
2022-06-30,Neurology,Toronto,674,44756,29060,3147.35,21574,3792,15696,23182
2022-07-01,Radiology,Sydney,963,25128,14848,3170.65,14179,1969,10280,10949
2022-07-02,Emergency,Tokyo,842,5009,2651,444.07,2829,449,2358,2180
2022-07-03,Emergency,Toronto,340,21644,16046,2188.8,10772,1877,5598,10872
2022-07-04,Neurology,Sydney,663,27422,21040,2721.15,9964,2207,6382,17458
2022-07-05,Pathology,Sydney,195,14865,11115,1601.38,8308,1106,3750,6557
2022-07-06,Dermatology,New York,999,7219,4947,985.81,4084,409,2272,3135
2022-07-07,Orthopedics,Sydney,833,44809,29211,6635.04,16086,2825,15598,28723
2022-07-08,Dermatology,Los Angeles,584,10287,8695,933.63,5361,729,1592,4926
2022-07-09,Psychiatry,Houston,506,39387,27871,5228.7,15201,3149,11516,24186
2022-07-10,Cardiology,Houston,330,13512,9345,1708.63,7307,1022,4167,6205
2022-07-11,Urology,Toronto,848,6342,3236,680.83,3799,408,3106,2543
2022-07-12,Gastroenterology,Los Angeles,754,48336,30765,7037.95,14936,2432,17571,33400
2022-07-13,Radiology,Chicago,270,24216,15790,1696.27,13783,1811,8426,10433
2022-07-14,Urology,Houston,640,32534,21457,1982.18,15837,2091,11077,16697
2022-07-15,Ophthalmology,Chicago,135,19231,14078,2603.8,11385,1667,5153,7846
2022-07-16,Dermatology,Berlin,624,37293,26606,3502.37,16390,1909,10687,20903
2022-07-17,Endocrinology,Los Angeles,259,31614,23494,4258.31,17520,2505,8120,14094
2022-07-18,Orthopedics,Chicago,938,41258,33252,5747.61,13149,4005,8006,28109
2022-07-19,Endocrinology,New York,798,33253,27440,1870.34,13320,1952,5813,19933
2022-07-20,Urology,Tokyo,342,47078,37062,6513.08,15069,3464,10016,32009
2022-07-21,General Surgery,Seoul,185,45752,40362,4338.75,27112,2496,5390,18640
2022-07-22,Radiology,Sydney,895,22988,11661,2322.78,12530,1868,11327,10458
2022-07-23,Orthopedics,Seoul,677,36037,20840,4059.9,20028,2793,15197,16009
2022-07-24,Emergency,Toronto,781,17219,8661,2456.09,10010,1211,8558,7209
2022-07-25,Oncology,New York,656,5235,3973,271.76,1704,398,1262,3531
2022-07-26,Pathology,Houston,673,47929,41181,4681.91,19923,4545,6748,28006
2022-07-27,Cardiology,Toronto,745,6908,4126,820.48,2219,413,2782,4689
2022-07-28,Gastroenterology,Toronto,895,13567,11814,1658.85,4928,693,1753,8639
2022-07-29,Ophthalmology,Seoul,127,41298,21644,4924.92,15231,3844,19654,26067
2022-07-30,Gastroenterology,Los Angeles,719,10256,8961,650.68,4520,808,1295,5736
2022-07-31,Orthopedics,Houston,655,24019,15387,1920.07,9140,2270,8632,14879
2022-08-01,Dermatology,Toronto,439,13162,7114,1130.24,4347,1050,6048,8815
2022-08-02,Endocrinology,Sydney,897,10415,7231,1358.57,3647,942,3184,6768
2022-08-03,Oncology,Houston,430,41159,24806,3205.3,14166,2942,16353,26993
2022-08-04,Dermatology,Tokyo,739,48925,30037,3477.12,28959,4280,18888,19966
2022-08-05,Ophthalmology,Los Angeles,605,10951,6821,1596.05,5779,1047,4130,5172
2022-08-06,Radiology,Berlin,447,26852,22051,1366.4,15851,2110,4801,11001
2022-08-07,Psychiatry,Houston,572,13007,9308,1948.22,5618,767,3699,7389
2022-08-08,Urology,Chicago,330,46832,29247,5511.29,17960,2971,17585,28872
2022-08-09,Orthopedics,Toronto,289,35523,26433,4719.12,19164,2128,9090,16359
2022-08-10,Psychiatry,Chicago,324,28325,22276,2250.76,11269,1765,6049,17056
2022-08-11,Urology,Los Angeles,484,26204,15959,1347.71,10214,1711,10245,15990
2022-08-12,Dermatology,New York,476,20524,13657,2540.6,7588,1595,6867,12936
2022-08-13,Neurology,Chicago,382,24282,13324,3239.57,8229,1927,10958,16053
2022-08-14,Pediatrics,Toronto,732,28930,16561,3588.7,10904,2063,12369,18026
2022-08-15,Oncology,Sydney,727,5077,3921,326.38,2064,410,1156,3013
2022-08-16,General Surgery,Sydney,844,45345,25963,5683.67,22772,2452,19382,22573
2022-08-17,Endocrinology,Toronto,358,25611,18185,3249.84,8164,1392,7426,17447
2022-08-18,Oncology,Seoul,458,21984,17227,2546.94,7983,1288,4757,14001
2022-08-19,Dermatology,Los Angeles,809,19060,10344,2413.22,10343,1446,8716,8717
2022-08-20,Endocrinology,Seoul,555,22449,16318,3021.46,7724,1362,6131,14725
2022-08-21,Ophthalmology,Toronto,510,23520,14173,2619.2,9473,1509,9347,14047
2022-08-22,Dermatology,Tokyo,748,48303,42756,2843.14,27020,3381,5547,21283
2022-08-23,Ophthalmology,Toronto,417,14510,10061,1433.05,5027,1314,4449,9483
2022-08-24,Cardiology,Berlin,776,34287,28197,1980.59,11137,1738,6090,23150
2022-08-25,Neurology,Berlin,324,33173,23887,3010.59,14773,2735,9286,18400
2022-08-26,General Surgery,Seoul,918,44711,23131,4055.76,17469,3730,21580,27242
2022-08-27,Pathology,Seoul,333,16954,12770,959.61,7951,1524,4184,9003
2022-08-28,Cardiology,Los Angeles,783,12804,11274,1086.83,6928,1237,1530,5876
2022-08-29,Radiology,Sydney,763,11565,8565,706.62,3945,589,3000,7620
2022-08-30,Ophthalmology,New York,926,10984,9091,1436.97,5208,633,1893,5776
2022-08-31,General Surgery,Tokyo,473,26526,22644,3840.14,11980,2501,3882,14546
2022-09-01,Ophthalmology,London,771,42438,25090,2428.8,14565,3094,17348,27873
2022-09-02,Psychiatry,Sydney,707,23574,13786,3430.29,11485,1844,9788,12089
2022-09-03,Endocrinology,Toronto,571,14184,10558,1450.42,5419,1179,3626,8765
2022-09-04,Orthopedics,New York,332,24096,16009,1926.63,10755,2022,8087,13341
2022-09-05,Pediatrics,Los Angeles,791,7192,6012,414.88,2335,694,1180,4857
2022-09-06,Cardiology,Houston,212,39016,33554,3904.04,17084,3895,5462,21932
2022-09-07,Pediatrics,Sydney,929,16246,10419,2103.07,6367,1397,5827,9879
2022-09-08,Ophthalmology,Sydney,596,23381,13905,2822.29,12782,1504,9476,10599
2022-09-09,Neurology,New York,541,41455,33670,2280.96,13145,3896,7785,28310
2022-09-10,Radiology,Toronto,663,31727,19351,1817.65,13502,1664,12376,18225
2022-09-11,Radiology,Sydney,367,9018,7476,814.21,3945,555,1542,5073
2022-09-12,Gastroenterology,New York,609,16302,10914,1296.48,8436,1546,5388,7866
2022-09-13,Pathology,Chicago,906,6970,5346,510.47,3291,437,1624,3679
2022-09-14,Psychiatry,Seoul,485,46157,24842,3604.88,23086,2817,21315,23071
2022-09-15,Radiology,Berlin,486,32202,24136,4197.48,17167,1832,8066,15035
2022-09-16,Endocrinology,Seoul,212,36110,24580,5160.94,20173,3356,11530,15937
2022-09-17,Dermatology,Toronto,712,22586,16592,2044.26,8902,1694,5994,13684
2022-09-18,Endocrinology,Chicago,724,29519,16743,4150.7,13620,2472,12776,15899
2022-09-19,Oncology,Sydney,180,36273,28827,2979.81,20023,2247,7446,16250
2022-09-20,Oncology,Tokyo,798,26951,22776,2631.6,16085,2369,4175,10866
2022-09-21,Urology,Seoul,212,20374,11953,1479.21,11549,1792,8421,8825
2022-09-22,Pathology,Los Angeles,101,10788,5807,1230.35,4438,708,4981,6350
2022-09-23,Dermatology,Seoul,741,10408,5302,1539.32,3731,734,5106,6677
2022-09-24,Oncology,London,319,30053,22743,3316.33,13428,1817,7310,16625
2022-09-25,Orthopedics,Tokyo,665,14446,10731,1239.2,7547,1427,3715,6899
2022-09-26,Dermatology,London,954,5922,4256,679.74,2651,487,1666,3271
2022-09-27,Psychiatry,London,835,38187,22636,2378.75,16991,3693,15551,21196
2022-09-28,Neurology,Los Angeles,324,15789,10363,2192.55,8707,1028,5426,7082
2022-09-29,Emergency,Chicago,484,37184,27434,3729.87,15186,3312,9750,21998
2022-09-30,Pediatrics,London,502,6120,4276,581.0,3414,540,1844,2706
2022-10-01,Ophthalmology,Tokyo,737,49028,43885,5323.78,20691,4146,5143,28337
2022-10-02,Dermatology,Seoul,229,37154,20604,4179.02,14804,3651,16550,22350
2022-10-03,Endocrinology,Toronto,152,22334,17377,1277.0,9742,1556,4957,12592
2022-10-04,Gastroenterology,Tokyo,783,7336,4854,867.57,3878,414,2482,3458
2022-10-05,Gastroenterology,Berlin,829,43141,28959,3200.77,14573,3605,14182,28568
2022-10-06,Pediatrics,New York,771,7243,5700,879.27,2599,626,1543,4644
2022-10-07,Gastroenterology,Seoul,809,24029,18669,3177.92,14067,1892,5360,9962
2022-10-08,Orthopedics,Los Angeles,515,37265,33408,4859.2,13141,2248,3857,24124
2022-10-09,Emergency,London,346,42380,23366,4460.5,19932,3187,19014,22448
2022-10-10,Urology,Toronto,935,48872,26471,4985.77,23155,3206,22401,25717
2022-10-11,Urology,London,538,28710,22673,1845.7,12830,2049,6037,15880
2022-10-12,General Surgery,Los Angeles,302,34486,25221,4398.16,17016,2836,9265,17470
2022-10-13,Pathology,Tokyo,283,11371,6932,877.17,4195,992,4439,7176
2022-10-14,Ophthalmology,Berlin,222,11359,6040,1132.15,5291,699,5319,6068
2022-10-15,Dermatology,New York,500,45631,24378,3578.72,18784,3206,21253,26847
2022-10-16,Pathology,Berlin,866,40996,35161,2598.44,20436,2601,5835,20560
2022-10-17,Radiology,Seoul,393,25103,14478,2835.53,8594,1504,10625,16509
2022-10-18,Pediatrics,Tokyo,379,19382,12198,1074.41,9134,1728,7184,10248
2022-10-19,Pediatrics,New York,936,23755,14031,2966.16,8446,2267,9724,15309
2022-10-20,Radiology,Houston,983,40659,26103,3324.23,15596,2785,14556,25063
2022-10-21,General Surgery,Berlin,709,8756,4621,437.92,3201,766,4135,5555
2022-10-22,Cardiology,London,297,25609,18121,2589.4,9087,2429,7488,16522
2022-10-23,Neurology,Sydney,610,21478,11319,1174.53,11763,1982,10159,9715
2022-10-24,Dermatology,Seoul,851,40442,33168,3138.98,15598,2391,7274,24844
2022-10-25,Pediatrics,Seoul,243,44666,26508,5391.08,25823,4368,18158,18843
2022-10-26,Neurology,New York,708,15147,10845,852.31,8951,1042,4302,6196
2022-10-27,Pediatrics,Houston,300,38561,32855,5164.62,18176,2582,5706,20385
2022-10-28,Cardiology,Toronto,223,39884,30325,2009.44,13676,2118,9559,26208
2022-10-29,Radiology,Berlin,286,10779,7687,805.0,4444,800,3092,6335
2022-10-30,Gastroenterology,Chicago,425,17298,10893,2146.52,9329,959,6405,7969
2022-10-31,Urology,Toronto,563,19153,12127,1563.4,7856,1195,7026,11297
2022-11-01,Cardiology,Seoul,448,48879,37529,2941.99,15939,3218,11350,32940
2022-11-02,Pediatrics,Seoul,870,15789,14173,1358.22,7374,1427,1616,8415
2022-11-03,Radiology,Los Angeles,759,49165,37598,3787.64,27214,4610,11567,21951
2022-11-04,Ophthalmology,New York,863,17999,13015,2416.75,9697,1172,4984,8302
2022-11-05,Cardiology,Sydney,502,5814,4606,472.88,2049,540,1208,3765
2022-11-06,Psychiatry,Houston,445,15541,10662,2003.13,7798,1443,4879,7743
2022-11-07,General Surgery,Chicago,610,29938,15689,4166.99,10961,2641,14249,18977
2022-11-08,Radiology,Toronto,246,7443,5395,695.04,2720,426,2048,4723
2022-11-09,Dermatology,Berlin,247,15457,13649,2179.35,8690,1306,1808,6767
2022-11-10,Pediatrics,New York,963,15380,8768,1349.32,5765,1495,6612,9615
2022-11-11,Orthopedics,Berlin,810,12783,9919,1871.53,4844,1075,2864,7939
2022-11-12,Urology,Tokyo,919,49241,28578,2901.72,14781,3278,20663,34460
2022-11-13,Pathology,Los Angeles,588,22368,15978,2655.12,12552,1678,6390,9816
2022-11-14,Pediatrics,Houston,739,20328,10950,2020.23,10931,1672,9378,9397
2022-11-15,Dermatology,Los Angeles,650,31215,21230,2770.8,15239,2357,9985,15976
2022-11-16,Oncology,Seoul,437,38595,30971,4371.7,20265,2161,7624,18330
2022-11-17,Gastroenterology,Los Angeles,971,32306,20644,3889.18,11165,2119,11662,21141
2022-11-18,Ophthalmology,Chicago,740,24915,19084,1256.62,10900,2245,5831,14015
2022-11-19,Ophthalmology,Seoul,878,44915,36748,2995.62,18207,4180,8167,26708
2022-11-20,Neurology,Toronto,572,42219,36767,5121.36,13853,2400,5452,28366
2022-11-21,Neurology,Berlin,250,20343,12080,2372.78,9069,1985,8263,11274
2022-11-22,Pathology,Toronto,514,43727,28847,6410.59,25196,2905,14880,18531
2022-11-23,Pediatrics,Tokyo,397,5126,2875,646.41,1599,426,2251,3527
2022-11-24,Endocrinology,Seoul,710,32632,29270,4734.16,12642,2858,3362,19990
2022-11-25,Pathology,Seoul,362,46563,40547,5599.39,16868,4218,6016,29695
2022-11-26,Endocrinology,Houston,863,49409,35375,3943.1,18352,4806,14034,31057
2022-11-27,Emergency,Seoul,243,25530,21363,1545.5,14616,1675,4167,10914
2022-11-28,Pediatrics,Berlin,445,44964,31851,5763.59,19803,4178,13113,25161
2022-11-29,Radiology,Chicago,723,49327,36967,5643.74,21698,2791,12360,27629
2022-11-30,Radiology,Tokyo,671,8368,4482,458.72,4419,713,3886,3949
2022-12-01,Urology,Houston,980,8797,7056,756.59,3046,766,1741,5751
2022-12-02,Emergency,Sydney,101,18718,10315,2726.84,8351,1570,8403,10367
2022-12-03,General Surgery,Berlin,996,39560,32851,3957.59,16971,2477,6709,22589
2022-12-04,Emergency,Chicago,403,16053,13048,1497.31,7690,1503,3005,8363
2022-12-05,Emergency,Los Angeles,353,27116,21245,2596.9,16266,1584,5871,10850
2022-12-06,Pathology,Toronto,751,41244,21218,2923.72,21893,2172,20026,19351
2022-12-07,Psychiatry,Tokyo,552,41185,25586,3577.77,17271,3536,15599,23914
2022-12-08,Gastroenterology,London,136,6645,4021,577.99,3643,490,2624,3002
2022-12-09,Cardiology,Berlin,259,24256,15622,1339.79,8519,2242,8634,15737
2022-12-10,Urology,Toronto,108,40840,21851,5176.75,12625,2824,18989,28215
2022-12-11,Urology,New York,332,39622,34660,3631.37,14316,2314,4962,25306
2022-12-12,Urology,Toronto,198,42430,30614,5610.01,17062,3896,11816,25368
2022-12-13,Radiology,Toronto,758,44282,27552,5979.61,20067,3429,16730,24215
2022-12-14,Cardiology,Sydney,915,7708,5077,548.81,3734,458,2631,3974
2022-12-15,Emergency,Sydney,307,16694,11333,1932.09,9568,1436,5361,7126
2022-12-16,Gastroenterology,Seoul,230,14524,10751,1412.14,6578,1097,3773,7946
2022-12-17,General Surgery,Chicago,503,36880,26047,5090.02,16610,2958,10833,20270
2022-12-18,Endocrinology,Seoul,251,44224,38375,3165.29,13933,3230,5849,30291
2022-12-19,Psychiatry,Berlin,153,41980,29335,4944.46,13033,3838,12645,28947
2022-12-20,Radiology,Seoul,219,37409,33550,4143.99,17408,3422,3859,20001
2022-12-21,Pediatrics,London,772,18224,15318,1449.36,7862,1557,2906,10362
2022-12-22,Pediatrics,London,727,45738,26683,2911.69,25236,2527,19055,20502
2022-12-23,Pediatrics,Berlin,686,30150,26297,3472.19,10498,2772,3853,19652
2022-12-24,Dermatology,Berlin,724,39393,21530,4879.21,12113,3291,17863,27280
2022-12-25,Pathology,Tokyo,519,48082,39762,3921.7,20901,4079,8320,27181
2022-12-26,Oncology,Seoul,521,12973,8461,1485.19,4816,884,4512,8157
2022-12-27,Emergency,London,203,13577,11556,1215.32,4275,1275,2021,9302
2022-12-28,Oncology,Houston,951,13070,11073,1585.66,6762,1127,1997,6308
2022-12-29,Orthopedics,Houston,353,13666,11238,955.55,4557,760,2428,9109
2022-12-30,Pathology,Sydney,326,41368,33756,5751.04,19959,2911,7612,21409
2022-12-31,Pediatrics,Tokyo,211,11783,7327,927.8,4528,1111,4456,7255
2023-01-01,Psychiatry,Houston,609,46914,24975,4071.13,16516,2456,21939,30398
2023-01-02,Ophthalmology,Tokyo,572,9971,6592,556.47,4127,977,3379,5844
2023-01-03,Radiology,New York,198,18490,10528,1130.69,9992,1552,7962,8498
2023-01-04,Pathology,London,252,6990,5438,710.09,2919,570,1552,4071
2023-01-05,Endocrinology,Seoul,960,10299,6575,790.54,5409,654,3724,4890
2023-01-06,Psychiatry,Tokyo,995,24956,22216,3332.82,8426,1558,2740,16530
2023-01-07,Psychiatry,Tokyo,977,27359,20694,1408.15,14550,2656,6665,12809
2023-01-08,Dermatology,Chicago,437,42148,34940,3705.21,15640,2735,7208,26508
2023-01-09,Radiology,Seoul,805,33734,18655,2824.7,16975,2994,15079,16759
2023-01-10,Cardiology,New York,921,9757,8242,506.71,4583,679,1515,5174
2023-01-11,Urology,Chicago,262,24097,20942,1504.54,13945,1372,3155,10152
2023-01-12,Dermatology,Berlin,819,15395,10696,1406.55,6407,777,4699,8988
2023-01-13,Psychiatry,Sydney,780,21241,15771,2108.94,6793,1640,5470,14448
2023-01-14,Cardiology,London,260,43356,34941,3920.64,13255,4283,8415,30101
2023-01-15,Radiology,Los Angeles,679,32696,18634,3370.75,17919,2238,14062,14777
2023-01-16,Ophthalmology,Seoul,900,9944,6971,1089.0,4548,674,2973,5396
2023-01-17,Endocrinology,Los Angeles,497,24816,16365,1265.43,13216,1667,8451,11600
2023-01-18,Psychiatry,Berlin,376,42011,23465,4050.26,15557,3193,18546,26454
2023-01-19,Pediatrics,Seoul,915,29917,19356,4378.35,12072,2155,10561,17845
2023-01-20,Oncology,New York,603,36195,19084,3688.39,11185,3402,17111,25010
2023-01-21,Emergency,Chicago,995,26566,13557,3128.26,15632,1999,13009,10934
2023-01-22,Pathology,Tokyo,491,14916,8264,1210.98,7463,1124,6652,7453
2023-01-23,Pathology,Chicago,234,25806,22844,3287.66,14966,1468,2962,10840
2023-01-24,Pediatrics,Los Angeles,294,14984,10785,1907.35,5688,1485,4199,9296
2023-01-25,Psychiatry,Seoul,500,6759,5990,690.29,3267,422,769,3492
2023-01-26,Emergency,Toronto,739,46949,31596,6929.74,23641,2519,15353,23308
2023-01-27,Ophthalmology,London,132,31838,19890,1991.63,12584,2647,11948,19254
2023-01-28,Cardiology,Sydney,787,7482,5255,386.78,4148,596,2227,3334
2023-01-29,Oncology,Tokyo,559,29442,19897,3739.6,17198,2083,9545,12244
2023-01-30,Emergency,Los Angeles,982,38719,20995,5061.18,21893,2753,17724,16826
2023-01-31,Cardiology,London,569,32965,24932,2044.51,17198,2942,8033,15767
2023-02-01,Emergency,Berlin,474,7079,4151,541.96,2712,423,2928,4367
2023-02-02,Orthopedics,Tokyo,121,7717,5771,399.4,2967,702,1946,4750
2023-02-03,Ophthalmology,London,849,32952,25046,2614.11,19408,2716,7906,13544
2023-02-04,Endocrinology,Seoul,769,25908,14529,3298.46,7852,1838,11379,18056
2023-02-05,Endocrinology,Berlin,137,47460,24894,4831.24,24433,3459,22566,23027
2023-02-06,Pathology,New York,329,29861,24256,2532.5,15285,1876,5605,14576
2023-02-07,Orthopedics,Sydney,464,12311,8419,1073.2,5993,1078,3892,6318
2023-02-08,Emergency,Los Angeles,662,33071,17304,1658.03,19744,2501,15767,13327
2023-02-09,Gastroenterology,Houston,537,28570,25654,2285.03,11244,1886,2916,17326
2023-02-10,Gastroenterology,Toronto,875,23449,12266,2688.33,9426,1871,11183,14023
2023-02-11,Endocrinology,Houston,382,38536,29981,5680.96,12473,3845,8555,26063
2023-02-12,Dermatology,Los Angeles,126,43258,38649,5827.12,18723,3104,4609,24535
2023-02-13,Urology,Tokyo,325,33865,20172,1773.15,12811,3252,13693,21054
2023-02-14,Gastroenterology,Los Angeles,376,11645,6485,1628.62,4693,783,5160,6952
2023-02-15,Pathology,Los Angeles,897,43000,23587,5517.75,23665,2267,19413,19335
2023-02-16,Oncology,Seoul,708,31737,19718,4063.53,18427,1910,12019,13310
2023-02-17,Pediatrics,Chicago,383,16485,8908,1579.26,5864,1169,7577,10621
2023-02-18,Orthopedics,Toronto,978,43565,33844,3912.16,17938,2656,9721,25627
2023-02-19,Pediatrics,New York,580,30522,16021,2450.66,17659,1526,14501,12863
2023-02-20,Cardiology,New York,552,17342,12204,981.03,5524,1660,5138,11818
2023-02-21,Neurology,London,928,45806,41164,3335.75,15010,4223,4642,30796
2023-02-22,Gastroenterology,New York,915,18087,14932,1350.38,6309,1575,3155,11778
2023-02-23,Dermatology,Toronto,758,42641,31813,4196.2,20406,2489,10828,22235
2023-02-24,Cardiology,London,615,39249,24432,4896.09,13546,2198,14817,25703
2023-02-25,Gastroenterology,London,646,15093,11313,1469.77,8911,805,3780,6182
2023-02-26,General Surgery,Tokyo,291,21438,15238,1195.91,9304,1847,6200,12134
2023-02-27,Cardiology,Chicago,148,45411,30445,6619.97,20455,4379,14966,24956
2023-02-28,Cardiology,Houston,611,31399,17341,4530.01,11743,2245,14058,19656
2023-03-01,Neurology,Berlin,116,24846,21234,3193.18,10964,1390,3612,13882
2023-03-02,Pathology,Tokyo,271,20708,14079,3088.24,10324,1565,6629,10384
2023-03-03,Dermatology,Sydney,319,49039,28337,5122.04,25762,3307,20702,23277
2023-03-04,Ophthalmology,Chicago,257,15998,10352,2340.14,8417,1099,5646,7581
2023-03-05,Psychiatry,Chicago,576,35678,23749,2053.64,16888,2892,11929,18790
2023-03-06,Dermatology,Chicago,145,15682,13031,1357.56,8959,1347,2651,6723
2023-03-07,Oncology,Los Angeles,472,13519,10726,980.64,7370,750,2793,6149
2023-03-08,Cardiology,Sydney,617,36480,29465,2538.4,19229,1888,7015,17251
2023-03-09,Dermatology,Tokyo,198,24694,12455,1582.4,7820,2462,12239,16874
2023-03-10,Radiology,Sydney,991,8300,5531,931.6,2507,511,2769,5793
2023-03-11,Psychiatry,Houston,844,11722,8117,1501.97,4263,617,3605,7459
2023-03-12,Oncology,Seoul,136,44986,22838,4850.83,22450,2676,22148,22536
2023-03-13,Radiology,Sydney,379,29160,17610,1886.54,12345,1514,11550,16815
2023-03-14,Neurology,Chicago,448,25059,20150,3285.55,10542,1743,4909,14517
2023-03-15,Radiology,Houston,596,40822,22649,4637.19,23079,3678,18173,17743
2023-03-16,Urology,Seoul,401,18575,13264,1649.77,10563,1245,5311,8012
2023-03-17,Psychiatry,Toronto,280,12970,7601,1522.85,7428,936,5369,5542
2023-03-18,Pediatrics,Seoul,706,39911,20149,3032.86,15731,3343,19762,24180
2023-03-19,Emergency,Toronto,198,26591,15861,2247.45,13490,2006,10730,13101
2023-03-20,Radiology,New York,799,36821,32783,5219.32,14046,3427,4038,22775
2023-03-21,Ophthalmology,Seoul,215,14503,11901,1146.47,5180,1353,2602,9323
2023-03-22,Neurology,Toronto,290,23922,21142,2320.41,8501,1207,2780,15421
2023-03-23,Pediatrics,Berlin,352,17175,11939,2387.57,6915,1526,5236,10260
2023-03-24,Neurology,Chicago,260,46124,25086,5570.49,19786,3368,21038,26338
2023-03-25,Neurology,Los Angeles,355,26389,18978,1483.6,14495,2624,7411,11894
2023-03-26,Cardiology,Seoul,422,5822,3969,376.86,1956,431,1853,3866
2023-03-27,Neurology,London,227,22327,18704,1133.86,11620,2218,3623,10707
2023-03-28,Radiology,Sydney,117,11150,6012,1260.98,5122,978,5138,6028
2023-03-29,Emergency,Toronto,892,9425,6553,893.18,3641,588,2872,5784
2023-03-30,Urology,Tokyo,834,21032,11778,1334.01,9419,1617,9254,11613
2023-03-31,Neurology,Toronto,665,7198,4533,1049.42,2807,716,2665,4391
2023-04-01,Neurology,Seoul,669,25079,19936,2582.28,12008,2329,5143,13071
2023-04-02,Dermatology,Toronto,422,41220,28458,3058.08,17730,2261,12762,23490
2023-04-03,General Surgery,Houston,971,46874,30484,4690.23,16374,3999,16390,30500
2023-04-04,Ophthalmology,Tokyo,785,18859,12405,2224.65,6317,1268,6454,12542
2023-04-05,Orthopedics,Seoul,891,36419,24902,2098.61,16898,1833,11517,19521
2023-04-06,Pediatrics,Los Angeles,725,13705,11155,1061.73,7821,961,2550,5884
2023-04-07,Urology,Houston,387,47880,41025,6257.75,19304,2956,6855,28576
2023-04-08,Gastroenterology,Tokyo,953,28236,24907,2709.71,14679,2567,3329,13557
2023-04-09,General Surgery,Sydney,762,27419,22339,2869.61,13643,1833,5080,13776
2023-04-10,Pediatrics,London,738,24978,15640,2329.99,14473,2282,9338,10505
2023-04-11,Orthopedics,Sydney,254,42609,33032,2317.5,23277,2131,9577,19332
2023-04-12,Emergency,Toronto,589,20358,13742,1355.33,9567,1331,6616,10791
2023-04-13,Oncology,Toronto,485,39177,23579,3704.35,19475,2431,15598,19702
2023-04-14,Urology,New York,884,34378,28751,2438.04,19578,2120,5627,14800
2023-04-15,Urology,Tokyo,203,42334,21817,2328.28,17774,2261,20517,24560
2023-04-16,Orthopedics,Toronto,492,16382,14100,2201.17,6520,972,2282,9862
2023-04-17,Pathology,New York,910,19596,13415,2902.54,5942,1524,6181,13654
2023-04-18,General Surgery,Sydney,345,38572,29117,4987.91,21136,2490,9455,17436
2023-04-19,Ophthalmology,New York,275,18221,13916,2466.73,9844,1291,4305,8377
2023-04-20,Endocrinology,Sydney,138,6279,5387,465.89,2080,432,892,4199
2023-04-21,Ophthalmology,Seoul,576,12083,9118,1764.88,5715,1133,2965,6368
2023-04-22,Radiology,Toronto,781,48861,36429,3405.25,21459,4654,12432,27402
2023-04-23,Cardiology,Houston,858,22771,11992,3305.05,7642,1699,10779,15129
2023-04-24,Pathology,Sydney,637,34975,24740,5228.13,20781,2326,10235,14194
2023-04-25,Neurology,London,966,24063,13476,2915.77,8768,1331,10587,15295
2023-04-26,Neurology,Houston,917,7106,5649,1052.5,2275,694,1457,4831
2023-04-27,Radiology,Houston,507,29557,20834,3161.24,14141,1566,8723,15416
2023-04-28,Radiology,Sydney,624,25607,19770,1944.96,13358,1661,5837,12249
2023-04-29,Dermatology,Toronto,927,42599,22009,3991.51,13194,2764,20590,29405
2023-04-30,Pediatrics,Chicago,605,33529,17901,3666.6,16684,2213,15628,16845
2023-05-01,Dermatology,Los Angeles,924,40954,32211,2347.0,18826,2384,8743,22128
2023-05-02,Orthopedics,New York,135,32856,17375,3687.57,10874,2929,15481,21982
2023-05-03,Oncology,Toronto,784,7573,4002,1121.7,2663,425,3571,4910
2023-05-04,Ophthalmology,Seoul,119,17808,8990,1228.94,8376,1455,8818,9432
2023-05-05,General Surgery,New York,420,40367,35627,5217.82,15699,2268,4740,24668
2023-05-06,Ophthalmology,Sydney,875,41801,33231,5885.16,24307,2237,8570,17494
2023-05-07,Radiology,London,611,46196,29625,6669.32,25205,4410,16571,20991
2023-05-08,Ophthalmology,Chicago,499,39072,24170,5705.04,23250,2325,14902,15822
2023-05-09,Pediatrics,Los Angeles,753,28752,18397,2936.9,10865,2618,10355,17887
2023-05-10,General Surgery,Toronto,982,22685,18371,3351.27,13404,1751,4314,9281
2023-05-11,Orthopedics,London,570,46401,35475,5834.05,19923,2500,10926,26478
2023-05-12,Oncology,Tokyo,242,16372,9398,1083.29,6618,1600,6974,9754
2023-05-13,Pathology,Chicago,191,13996,7972,1367.27,4410,872,6024,9586
2023-05-14,Psychiatry,Houston,453,21458,11573,2614.3,6777,1995,9885,14681
2023-05-15,Dermatology,Chicago,933,36889,28187,2756.86,18724,2155,8702,18165
2023-05-16,Gastroenterology,Berlin,899,31665,25514,3611.76,13849,2935,6151,17816
2023-05-17,Orthopedics,London,826,43243,26206,5044.73,15911,2190,17037,27332
2023-05-18,Neurology,Berlin,953,36653,18633,2428.99,17747,2770,18020,18906
2023-05-19,Endocrinology,Berlin,150,31657,16869,3371.74,11898,2800,14788,19759
2023-05-20,Urology,Toronto,764,44952,39878,5716.22,21275,4348,5074,23677
2023-05-21,Dermatology,Chicago,797,27180,16802,2715.0,11082,2594,10378,16098
2023-05-22,Cardiology,Toronto,674,36896,29800,1889.46,20184,3356,7096,16712
2023-05-23,Urology,Seoul,289,17875,13403,909.91,9763,1687,4472,8112
2023-05-24,Psychiatry,Toronto,224,6622,4322,567.52,2934,397,2300,3688
2023-05-25,Dermatology,London,249,45809,26673,6533.25,18563,2941,19136,27246
2023-05-26,Orthopedics,Los Angeles,413,21725,11917,1583.05,8880,1400,9808,12845
2023-05-27,Ophthalmology,Seoul,669,45760,34137,5190.85,24788,3150,11623,20972
2023-05-28,Urology,Los Angeles,441,20646,16720,1490.8,8226,1438,3926,12420
2023-05-29,Radiology,Chicago,404,22029,16688,1810.06,7990,1701,5341,14039
2023-05-30,Ophthalmology,Houston,791,34402,24498,4637.53,11194,1995,9904,23208
2023-05-31,Oncology,Tokyo,781,9263,4786,1138.29,4075,783,4477,5188
2023-06-01,Orthopedics,Berlin,937,35987,31934,2142.66,16001,2100,4053,19986
2023-06-02,Radiology,London,882,13646,11182,1267.31,7536,894,2464,6110
2023-06-03,Ophthalmology,Los Angeles,153,32529,20074,1721.34,11917,2445,12455,20612
2023-06-04,Radiology,Tokyo,543,16664,14864,1634.56,6903,1496,1800,9761
2023-06-05,Gastroenterology,New York,712,40737,30176,4735.41,22100,3543,10561,18637
2023-06-06,Dermatology,Toronto,363,40796,29902,2523.24,22318,3356,10894,18478
2023-06-07,Oncology,Berlin,152,29027,23199,2289.9,12057,1677,5828,16970
2023-06-08,Orthopedics,Los Angeles,671,34373,28347,3086.13,15046,2658,6026,19327
2023-06-09,Orthopedics,Seoul,719,41397,31568,5876.43,16185,2250,9829,25212
2023-06-10,Neurology,London,104,25609,14116,3824.08,14847,1763,11493,10762
2023-06-11,Pediatrics,Toronto,202,40835,25942,2225.15,13703,2886,14893,27132
2023-06-12,Gastroenterology,Sydney,295,43709,38080,5511.74,25356,2272,5629,18353
2023-06-13,General Surgery,Tokyo,873,24250,14303,2113.93,12250,1544,9947,12000
2023-06-14,Pediatrics,London,976,26172,16982,2335.74,12025,2559,9190,14147
2023-06-15,Urology,Los Angeles,983,16555,11138,2076.44,5128,1617,5417,11427
2023-06-16,Urology,Houston,449,26874,18160,3811.88,11896,1817,8714,14978
2023-06-17,Psychiatry,Seoul,146,18081,13473,2623.42,7636,943,4608,10445
2023-06-18,Orthopedics,New York,966,29063,25494,3130.44,10124,1713,3569,18939
2023-06-19,Dermatology,Sydney,922,11819,7047,1013.03,5873,822,4772,5946
2023-06-20,Pathology,Berlin,919,30712,16848,3954.32,18161,2991,13864,12551
2023-06-21,Orthopedics,London,755,29762,17231,2235.13,13948,1698,12531,15814
2023-06-22,Ophthalmology,Sydney,368,16046,13715,1707.41,8254,1414,2331,7792
2023-06-23,Ophthalmology,Houston,469,36463,27650,3130.63,11687,2021,8813,24776
2023-06-24,Psychiatry,Los Angeles,735,33769,20746,3905.83,14361,3345,13023,19408
2023-06-25,Cardiology,Seoul,205,28150,23262,2084.22,9427,1944,4888,18723
2023-06-26,Radiology,Toronto,769,7711,6512,533.29,3730,684,1199,3981
2023-06-27,Urology,Tokyo,758,9853,8262,1397.39,5729,661,1591,4124
2023-06-28,Emergency,Los Angeles,756,34077,29564,2050.77,16988,2773,4513,17089
2023-06-29,Psychiatry,Chicago,219,28863,17343,2903.5,9323,1720,11520,19540
2023-06-30,Orthopedics,New York,930,26792,21487,1931.31,10888,1535,5305,15904
2023-07-01,Cardiology,New York,886,45483,31120,2451.22,21158,4407,14363,24325
2023-07-02,Cardiology,Toronto,703,13942,11666,747.32,5869,1336,2276,8073
2023-07-03,General Surgery,Seoul,157,6762,5351,456.58,3719,638,1411,3043
2023-07-04,Endocrinology,Los Angeles,445,36987,29980,5055.27,20135,3005,7007,16852
2023-07-05,Oncology,Los Angeles,840,20850,15897,1631.47,10082,1885,4953,10768
2023-07-06,Urology,Houston,573,17112,9770,2482.03,7050,914,7342,10062
2023-07-07,Orthopedics,Berlin,216,29058,20863,3142.98,10943,1939,8195,18115
2023-07-08,Oncology,Chicago,929,43890,39231,4110.8,14561,2882,4659,29329
2023-07-09,Gastroenterology,Tokyo,890,5481,4795,592.0,2227,448,686,3254
2023-07-10,Pathology,Seoul,226,37921,19615,3855.42,16076,2570,18306,21845
2023-07-11,Dermatology,London,492,45385,25684,5712.96,22817,2606,19701,22568
2023-07-12,Gastroenterology,Berlin,740,6524,3605,510.5,3245,520,2919,3279
2023-07-13,Emergency,Tokyo,157,39888,31527,3402.65,12805,3618,8361,27083
2023-07-14,Dermatology,Sydney,733,20048,16581,2794.88,8391,1385,3467,11657
2023-07-15,Cardiology,Chicago,612,40111,23481,5801.88,14220,2270,16630,25891
2023-07-16,Radiology,Tokyo,850,42904,30133,5974.63,14889,2567,12771,28015
2023-07-17,Radiology,Los Angeles,901,39008,32621,3586.58,21383,2413,6387,17625
2023-07-18,Ophthalmology,Seoul,195,5060,4013,647.86,1581,328,1047,3479
2023-07-19,Gastroenterology,Sydney,737,14130,10129,1379.56,6015,1160,4001,8115
2023-07-20,Ophthalmology,Tokyo,217,23023,16948,2296.64,8068,1842,6075,14955
2023-07-21,Oncology,Toronto,659,18350,12906,1293.09,10345,1556,5444,8005
2023-07-22,Dermatology,New York,700,29354,18170,3202.9,13711,1999,11184,15643
2023-07-23,Cardiology,London,587,33145,24063,2274.2,12244,3022,9082,20901
2023-07-24,Psychiatry,Houston,336,39020,30262,3244.77,17587,2349,8758,21433
2023-07-25,General Surgery,Seoul,984,25587,21731,3467.12,13291,1879,3856,12296
2023-07-26,Neurology,Seoul,996,46131,34806,3261.81,27098,4153,11325,19033
2023-07-27,Dermatology,Houston,371,14650,11785,836.75,5363,864,2865,9287
2023-07-28,Oncology,London,288,24933,14062,1418.71,14108,1383,10871,10825
2023-07-29,Emergency,Los Angeles,803,25581,17513,3685.67,14844,2409,8068,10737
2023-07-30,Oncology,London,546,28393,14302,2858.95,16323,1906,14091,12070
2023-07-31,Cardiology,Berlin,680,28051,16793,2550.99,13762,2361,11258,14289
2023-08-01,Orthopedics,London,889,31212,24675,4091.51,15260,1600,6537,15952
2023-08-02,General Surgery,New York,960,9090,8151,1214.27,3826,768,939,5264
2023-08-03,Ophthalmology,Tokyo,346,11960,6454,995.3,6287,787,5506,5673
2023-08-04,Ophthalmology,Toronto,175,40772,26933,4866.62,18730,2152,13839,22042
2023-08-05,Endocrinology,Houston,253,26520,21747,3371.02,13345,2134,4773,13175
2023-08-06,Psychiatry,Los Angeles,755,41408,24083,4781.18,17744,2568,17325,23664
2023-08-07,Cardiology,Seoul,534,33470,24166,2180.89,17385,2320,9304,16085
2023-08-08,Ophthalmology,Los Angeles,185,25491,20220,3507.26,13952,1377,5271,11539
2023-08-09,General Surgery,Houston,796,6341,4732,658.89,2180,363,1609,4161
2023-08-10,Pediatrics,Sydney,384,49623,28543,3882.86,27286,3220,21080,22337
2023-08-11,Urology,New York,319,29791,19130,2756.35,13766,1623,10661,16025
2023-08-12,Pediatrics,New York,168,5338,4342,286.96,2954,509,996,2384
2023-08-13,Urology,London,146,10895,7862,684.06,4678,548,3033,6217
2023-08-14,Radiology,Houston,193,17254,8663,2183.57,7138,1280,8591,10116
2023-08-15,General Surgery,Chicago,849,16344,13147,817.22,9389,917,3197,6955
2023-08-16,Endocrinology,Sydney,552,6750,3470,618.68,2533,441,3280,4217
2023-08-17,Dermatology,Houston,303,7421,5924,758.8,4105,714,1497,3316
2023-08-18,Ophthalmology,Los Angeles,317,44887,26078,2489.59,19983,2607,18809,24904
2023-08-19,Psychiatry,Berlin,573,10319,9114,1520.07,4687,1014,1205,5632
2023-08-20,Emergency,Houston,531,20896,13523,1517.31,8202,1259,7373,12694
2023-08-21,Neurology,Sydney,440,16918,10671,1360.54,7983,1473,6247,8935
2023-08-22,Gastroenterology,Houston,650,30064,16822,2416.97,11952,2324,13242,18112
2023-08-23,Oncology,Houston,711,32935,20493,2405.63,10268,3103,12442,22667
2023-08-24,Ophthalmology,London,388,42641,36273,2138.33,16271,3313,6368,26370
2023-08-25,Ophthalmology,Chicago,353,34711,31189,4267.18,10479,2663,3522,24232
2023-08-26,Pediatrics,Sydney,833,9806,6347,1438.39,5819,586,3459,3987
2023-08-27,Psychiatry,New York,456,46360,31499,3357.82,27339,2703,14861,19021
2023-08-28,Oncology,Toronto,122,17182,13553,1998.35,7191,1646,3629,9991
2023-08-29,Endocrinology,Chicago,861,27297,23324,3390.0,14153,1812,3973,13144
2023-08-30,Endocrinology,Chicago,621,24541,18092,3309.17,9908,1683,6449,14633
2023-08-31,Oncology,Berlin,857,33921,22272,3129.65,17005,2984,11649,16916
2023-09-01,Ophthalmology,Toronto,936,21774,14480,1748.3,11793,1457,7294,9981
2023-09-02,Emergency,Chicago,199,49813,38766,4111.04,29092,4861,11047,20721
2023-09-03,Cardiology,Los Angeles,901,42198,21153,5117.02,17725,3666,21045,24473
2023-09-04,Oncology,New York,279,13820,10335,1819.79,7393,1103,3485,6427
2023-09-05,Gastroenterology,Chicago,322,29070,18668,1981.45,11040,2733,10402,18030
2023-09-06,Ophthalmology,New York,861,9232,7548,804.05,5512,484,1684,3720
2023-09-07,General Surgery,London,758,16122,8660,2260.21,4961,1013,7462,11161
2023-09-08,Endocrinology,Houston,541,20023,14722,2616.39,9632,1466,5301,10391
2023-09-09,Ophthalmology,Sydney,707,13007,9005,1931.36,6475,797,4002,6532
2023-09-10,Emergency,London,868,22905,17337,2872.86,11599,1997,5568,11306
2023-09-11,Endocrinology,New York,424,46786,24606,4178.9,15725,4489,22180,31061
2023-09-12,Urology,Chicago,615,34398,25179,3751.58,20004,2448,9219,14394
2023-09-13,Psychiatry,Toronto,115,39268,28453,4559.07,13914,2635,10815,25354
2023-09-14,Gastroenterology,New York,891,11737,8500,678.93,5713,1151,3237,6024
2023-09-15,Endocrinology,Chicago,435,41062,30443,4288.91,15061,2966,10619,26001
2023-09-16,Pediatrics,Tokyo,858,30510,23510,3689.64,11964,2271,7000,18546
2023-09-17,Orthopedics,Berlin,357,24426,20078,1630.0,11332,1650,4348,13094
2023-09-18,Oncology,Los Angeles,596,42265,25694,5412.59,17969,4035,16571,24296
2023-09-19,Endocrinology,Los Angeles,995,22850,18965,2476.42,7953,1792,3885,14897
2023-09-20,Gastroenterology,Seoul,259,5614,3925,815.28,1972,494,1689,3642
2023-09-21,Radiology,Seoul,574,26776,14213,1452.39,11391,2425,12563,15385
2023-09-22,Emergency,London,951,29077,15219,2225.34,15328,1950,13858,13749
2023-09-23,Psychiatry,Berlin,763,14374,9108,1583.37,8184,1030,5266,6190
2023-09-24,Cardiology,Sydney,789,40435,32912,3220.89,13151,3737,7523,27284
2023-09-25,Psychiatry,Los Angeles,774,35907,28117,4360.63,15006,2447,7790,20901
2023-09-26,Pathology,Seoul,479,18409,15011,2317.7,6076,1651,3398,12333
2023-09-27,Pediatrics,Berlin,644,21514,15208,1296.25,6561,2087,6306,14953
2023-09-28,Pediatrics,Houston,790,34866,23572,3534.9,17381,2829,11294,17485
2023-09-29,Psychiatry,Sydney,526,7983,4462,805.4,3837,695,3521,4146
2023-09-30,Ophthalmology,New York,712,36705,23171,3190.7,12806,3312,13534,23899
2023-10-01,Pathology,Berlin,367,25662,17286,3677.17,9498,2367,8376,16164
2023-10-02,General Surgery,Toronto,934,28510,15265,3784.72,8755,1988,13245,19755
2023-10-03,Orthopedics,Seoul,676,17651,10383,2113.19,9716,927,7268,7935
2023-10-04,Psychiatry,New York,516,45998,34005,5585.66,27249,3224,11993,18749
2023-10-05,Endocrinology,New York,267,33535,26635,3225.12,11423,2806,6900,22112
2023-10-06,Psychiatry,Seoul,941,11640,10468,1654.04,4300,844,1172,7340
2023-10-07,Pediatrics,Tokyo,142,49547,43266,5918.86,27772,4332,6281,21775
2023-10-08,Pediatrics,Tokyo,655,20317,15380,2496.92,11741,1378,4937,8576
2023-10-09,Cardiology,Los Angeles,384,12564,8399,1710.83,5350,1026,4165,7214
2023-10-10,Urology,Seoul,496,32345,24403,2503.73,10194,1918,7942,22151
2023-10-11,Pediatrics,Seoul,111,33687,27429,4403.13,10504,2946,6258,23183
2023-10-12,Emergency,Los Angeles,706,18737,10255,1302.67,8847,1448,8482,9890
2023-10-13,General Surgery,Los Angeles,401,14323,9509,1210.78,5985,862,4814,8338
2023-10-14,Orthopedics,London,997,20229,16909,1690.36,6242,1306,3320,13987
2023-10-15,Psychiatry,Sydney,352,49481,32337,7315.89,23502,4326,17144,25979
2023-10-16,Radiology,Chicago,598,13502,9839,1831.6,4096,1000,3663,9406
2023-10-17,Endocrinology,Los Angeles,853,5545,4076,666.05,2973,337,1469,2572
2023-10-18,Orthopedics,Chicago,134,42114,24164,5167.63,16505,4142,17950,25609
2023-10-19,General Surgery,Toronto,826,34430,22203,3656.72,10744,2952,12227,23686
2023-10-20,Urology,Sydney,948,14996,9504,2170.06,7145,1467,5492,7851
2023-10-21,Dermatology,Sydney,189,32788,16737,3266.53,13748,2339,16051,19040
2023-10-22,Emergency,Berlin,875,34969,17822,3079.08,20706,2579,17147,14263
2023-10-23,Urology,London,704,18919,15753,1254.4,8764,1795,3166,10155
2023-10-24,Psychiatry,Tokyo,701,8810,5367,1133.15,3370,671,3443,5440
2023-10-25,Dermatology,Sydney,517,35586,25167,4392.89,18249,3037,10419,17337
2023-10-26,General Surgery,Berlin,214,44974,27860,3977.3,17155,2815,17114,27819
2023-10-27,Cardiology,Toronto,716,46773,40985,2456.49,26720,3383,5788,20053
2023-10-28,Radiology,Seoul,295,21371,12902,2861.57,8813,1200,8469,12558
2023-10-29,Ophthalmology,Berlin,925,34629,23265,1770.99,16101,2088,11364,18528
2023-10-30,Orthopedics,Sydney,600,13436,11408,1617.29,4234,672,2028,9202
2023-10-31,Oncology,Tokyo,725,17984,15048,2644.11,7694,934,2936,10290
2023-11-01,Neurology,Los Angeles,592,38039,21851,3566.77,20910,3760,16188,17129
2023-11-02,Orthopedics,Los Angeles,174,24895,20440,1829.72,13485,1546,4455,11410
2023-11-03,Cardiology,Berlin,512,23155,15821,2789.88,8504,1925,7334,14651
2023-11-04,Radiology,Houston,475,15616,10824,2056.83,5743,1435,4792,9873
2023-11-05,Neurology,Tokyo,519,42129,23313,4408.51,22968,3266,18816,19161
2023-11-06,Emergency,Seoul,828,44837,23864,6577.75,25965,2585,20973,18872
2023-11-07,General Surgery,Houston,376,29574,23398,1631.51,9718,2555,6176,19856
2023-11-08,Gastroenterology,Tokyo,860,8430,5889,847.04,3667,674,2541,4763
2023-11-09,Endocrinology,London,775,17676,11926,2153.74,7092,1530,5750,10584
2023-11-10,General Surgery,Seoul,493,15816,12523,2155.15,8876,1399,3293,6940
2023-11-11,Emergency,Tokyo,968,37733,30420,2563.04,12265,3726,7313,25468
2023-11-12,Neurology,Tokyo,556,25144,14170,3268.73,9135,1978,10974,16009
2023-11-13,Dermatology,Los Angeles,291,7050,5245,742.16,3706,472,1805,3344
2023-11-14,Radiology,London,838,49460,27407,4434.35,15599,4076,22053,33861
2023-11-15,Emergency,Tokyo,788,38933,31167,2459.46,17432,2079,7766,21501
2023-11-16,Ophthalmology,London,198,29951,22846,4089.2,12957,2841,7105,16994
2023-11-17,Neurology,Toronto,647,37413,33022,2459.06,14977,2093,4391,22436
2023-11-18,Pediatrics,London,195,39801,20998,3223.04,16651,2642,18803,23150
2023-11-19,Orthopedics,Chicago,763,37913,19821,2995.3,17401,3442,18092,20512
2023-11-20,Cardiology,Seoul,762,45600,27947,6253.65,15887,3641,17653,29713
2023-11-21,Gastroenterology,Los Angeles,289,30280,18309,3550.94,14280,2109,11971,16000
2023-11-22,Emergency,Los Angeles,835,29557,17698,3832.6,16008,2177,11859,13549
2023-11-23,Cardiology,Los Angeles,136,40400,34845,3031.89,21333,3746,5555,19067
2023-11-24,Dermatology,Los Angeles,879,9494,5694,1067.96,3286,636,3800,6208
2023-11-25,Ophthalmology,Tokyo,468,20152,12268,2159.78,6947,1883,7884,13205
2023-11-26,Endocrinology,Los Angeles,794,28895,23224,3851.21,10993,1572,5671,17902
2023-11-27,Dermatology,London,624,14155,9623,1990.32,5779,1257,4532,8376
2023-11-28,Urology,Chicago,378,36883,29900,1888.99,15584,3407,6983,21299
2023-11-29,Gastroenterology,Berlin,316,48194,25357,5658.07,24285,2847,22837,23909
2023-11-30,Gastroenterology,New York,966,48001,33362,2648.87,15216,3432,14639,32785
2023-12-01,Gastroenterology,Sydney,972,6828,3505,716.16,2119,397,3323,4709
2023-12-02,Urology,Berlin,897,46898,24624,3693.84,19583,4001,22274,27315
2023-12-03,Pediatrics,Berlin,372,37123,32021,2995.0,18901,2849,5102,18222
2023-12-04,General Surgery,London,980,42573,23657,3631.3,15242,3481,18916,27331
2023-12-05,Emergency,Los Angeles,161,5806,4139,651.02,2859,347,1667,2947
2023-12-06,Radiology,Tokyo,695,45970,30544,3834.13,17374,2785,15426,28596
2023-12-07,Urology,London,979,34757,22207,4284.49,19666,1809,12550,15091
2023-12-08,Ophthalmology,Tokyo,828,39636,34084,3585.18,22541,2620,5552,17095
2023-12-09,General Surgery,New York,441,19561,9951,1111.76,7612,1525,9610,11949
2023-12-10,Neurology,Toronto,496,29262,22400,3756.54,10797,2718,6862,18465
2023-12-11,General Surgery,Sydney,798,19899,17617,1563.58,8425,1658,2282,11474
2023-12-12,Urology,Toronto,118,20934,15157,1952.65,7790,1502,5777,13144
2023-12-13,Psychiatry,London,276,43197,37785,5120.76,21672,4218,5412,21525
2023-12-14,Radiology,Los Angeles,711,46844,24401,3899.56,25662,4026,22443,21182
2023-12-15,Gastroenterology,Sydney,495,41332,27589,2300.48,20745,3988,13743,20587
2023-12-16,Ophthalmology,Berlin,544,39157,23653,3422.01,21430,2990,15504,17727
2023-12-17,Orthopedics,Houston,332,16593,13147,2396.77,6954,1044,3446,9639
2023-12-18,Dermatology,Chicago,175,45042,40200,5142.6,15624,2371,4842,29418
2023-12-19,Orthopedics,Seoul,364,22320,13450,2614.74,11637,1926,8870,10683
2023-12-20,Urology,Houston,554,32376,24659,3665.88,13214,1815,7717,19162
2023-12-21,Emergency,Los Angeles,895,48513,28100,3391.02,24323,3160,20413,24190
2023-12-22,General Surgery,London,817,19199,13941,1763.11,7318,1471,5258,11881
2023-12-23,Emergency,Berlin,834,20876,14312,2611.46,6771,1632,6564,14105
2023-12-24,Gastroenterology,London,483,13245,11772,796.52,7917,1059,1473,5328
2023-12-25,Orthopedics,Los Angeles,663,12214,9080,950.07,4236,712,3134,7978
2023-12-26,Dermatology,Toronto,950,5726,3663,444.52,3415,395,2063,2311
2023-12-27,Oncology,Sydney,605,16362,8927,1524.97,9705,1323,7435,6657
2023-12-28,Pediatrics,Houston,466,23297,13057,3448.82,12537,2294,10240,10760
2023-12-29,Emergency,Tokyo,243,35448,20918,2011.68,17646,3062,14530,17802
2023-12-30,Urology,Berlin,984,31172,18715,3175.49,14755,2996,12457,16417
2023-12-31,Emergency,Sydney,168,47874,40225,3252.39,26801,4218,7649,21073
2024-01-01,Urology,Sydney,198,12657,9169,1861.44,4896,1007,3488,7761
2024-01-02,Gastroenterology,Berlin,495,23850,16918,1462.73,10501,1421,6932,13349
2024-01-03,Ophthalmology,New York,124,30425,16609,2749.21,14780,2535,13816,15645
2024-01-04,Oncology,Sydney,990,31685,26743,3922.24,13414,2571,4942,18271
2024-01-05,Neurology,Toronto,568,29578,23340,3562.83,12666,2369,6238,16912
2024-01-06,Neurology,New York,583,33831,17831,3121.68,13501,2520,16000,20330
2024-01-07,Orthopedics,Chicago,664,12906,10107,1092.52,6056,986,2799,6850
2024-01-08,Emergency,Toronto,250,12287,8814,1102.9,6821,819,3473,5466
2024-01-09,Dermatology,Toronto,243,38660,20593,2954.69,13935,2936,18067,24725
2024-01-10,Psychiatry,London,668,15222,10401,1073.66,8833,911,4821,6389
2024-01-11,Cardiology,London,138,42443,29450,4172.32,21506,3830,12993,20937
2024-01-12,Orthopedics,New York,208,39701,22483,3051.16,21715,2353,17218,17986
2024-01-13,Orthopedics,Chicago,792,22764,19993,1792.58,10627,1234,2771,12137
2024-01-14,Pediatrics,Chicago,141,49641,41697,5742.25,26501,3564,7944,23140
2024-01-15,Emergency,Sydney,285,22674,17404,3329.76,6912,1880,5270,15762
2024-01-16,Endocrinology,Tokyo,497,23024,15769,2541.01,12559,1655,7255,10465
2024-01-17,Neurology,Los Angeles,322,28874,19192,1665.97,9009,1843,9682,19865
2024-01-18,Neurology,Chicago,733,48642,36986,2799.75,27578,3789,11656,21064
2024-01-19,Urology,New York,232,37284,26776,5411.49,22280,2511,10508,15004
2024-01-20,General Surgery,Los Angeles,262,22602,11863,1802.04,8774,2184,10739,13828
2024-01-21,Pathology,Berlin,314,42784,30162,2533.1,15534,4112,12622,27250
2024-01-22,Pathology,Houston,832,28265,23249,3106.45,14969,2123,5016,13296
2024-01-23,Pathology,Tokyo,334,30931,21147,3475.56,11627,2053,9784,19304
2024-01-24,Urology,Tokyo,942,33841,17623,3886.66,18939,2939,16218,14902
2024-01-25,Pediatrics,Seoul,757,34192,27849,2623.9,11312,1772,6343,22880
2024-01-26,Dermatology,London,850,47520,27587,2447.81,16051,3504,19933,31469
2024-01-27,Pathology,Chicago,687,20585,12421,3015.73,12222,1375,8164,8363
2024-01-28,Endocrinology,London,108,30559,17292,2294.65,15345,2934,13267,15214
2024-01-29,Ophthalmology,Toronto,173,45059,28481,5299.06,24965,2279,16578,20094
2024-01-30,Endocrinology,London,591,38742,31098,4674.73,15392,3007,7644,23350
2024-01-31,Gastroenterology,Sydney,352,9133,6463,1013.77,4593,794,2670,4540
2024-02-01,Oncology,Sydney,329,19663,11442,1598.42,9404,1459,8221,10259
2024-02-02,Urology,Los Angeles,618,26754,22771,2062.99,12867,1451,3983,13887
2024-02-03,Radiology,New York,273,8972,7642,984.83,4528,884,1330,4444
2024-02-04,Orthopedics,Chicago,752,10295,8732,1406.4,4865,781,1563,5430
2024-02-05,Dermatology,Chicago,267,46873,27913,6781.28,20095,3783,18960,26778
2024-02-06,Urology,Sydney,269,34125,23221,2067.65,13062,2109,10904,21063
2024-02-07,Urology,New York,492,45996,41120,3011.95,24404,3411,4876,21592
2024-02-08,Neurology,Los Angeles,894,14903,12053,2153.09,5482,1064,2850,9421
2024-02-09,General Surgery,Toronto,733,8020,4097,991.7,4071,431,3923,3949
2024-02-10,Radiology,Seoul,293,46755,24596,6466.19,17299,2585,22159,29456
2024-02-11,Psychiatry,Tokyo,616,25420,17427,1786.09,12394,2335,7993,13026
2024-02-12,Endocrinology,Seoul,128,26452,22846,2876.88,13864,1639,3606,12588
2024-02-13,Pediatrics,Sydney,264,43001,30766,5165.02,15721,2569,12235,27280
2024-02-14,Urology,Seoul,521,14516,10148,1713.05,4615,1092,4368,9901
2024-02-15,Orthopedics,Tokyo,438,7396,4010,671.67,2509,654,3386,4887
2024-02-16,Pediatrics,Toronto,747,23546,17958,1213.55,11344,1250,5588,12202
2024-02-17,Endocrinology,Houston,595,24129,19999,2612.99,13387,1902,4130,10742
2024-02-18,Pediatrics,Berlin,464,6591,4298,496.37,2066,368,2293,4525
2024-02-19,Oncology,Los Angeles,932,16303,13209,1549.2,8481,844,3094,7822
2024-02-20,Cardiology,London,441,35561,31499,5183.3,14309,1871,4062,21252
2024-02-21,Cardiology,Tokyo,599,11183,6502,1005.39,4960,1025,4681,6223
2024-02-22,Pediatrics,Los Angeles,756,31572,22395,4230.02,18269,1764,9177,13303
2024-02-23,Pathology,Toronto,610,39080,24028,2690.82,15616,2042,15052,23464
2024-02-24,Neurology,Sydney,426,25695,20996,3012.64,11295,1847,4699,14400
2024-02-25,Psychiatry,Seoul,316,12314,9001,1818.79,3744,1135,3313,8570
2024-02-26,Endocrinology,Berlin,400,24623,18561,1482.04,7989,1554,6062,16634
2024-02-27,Radiology,Toronto,231,7139,5848,362.89,2695,507,1291,4444
2024-02-28,Pathology,New York,903,36290,23892,3387.97,11190,1886,12398,25100
2024-02-29,Emergency,Houston,169,23088,19995,1368.25,11299,1672,3093,11789
2024-03-01,Ophthalmology,Tokyo,351,44692,31874,5579.28,19124,3525,12818,25568
2024-03-02,Urology,Sydney,514,38130,21474,5393.67,17709,2994,16656,20421
2024-03-03,Neurology,New York,886,37088,28867,3464.1,13069,2470,8221,24019
2024-03-04,Pediatrics,New York,544,31292,25575,2374.16,12165,2058,5717,19127
2024-03-05,Gastroenterology,Houston,975,25670,16087,2398.61,12813,1420,9583,12857
2024-03-06,Gastroenterology,Toronto,281,8738,7365,1069.05,5151,597,1373,3587
2024-03-07,Emergency,Houston,266,7469,6441,380.21,2353,410,1028,5116
2024-03-08,Pathology,Chicago,190,27534,16816,2999.7,15614,2432,10718,11920
2024-03-09,Emergency,Toronto,813,14017,12522,1560.5,6630,1378,1495,7387
2024-03-10,Pediatrics,Toronto,957,7808,4343,888.31,3663,769,3465,4145
2024-03-11,Oncology,London,630,17713,10287,1314.34,7972,1651,7426,9741
2024-03-12,Urology,Los Angeles,138,45329,26004,5503.18,14542,3628,19325,30787
2024-03-13,Gastroenterology,New York,225,7719,6619,456.5,2523,656,1100,5196
2024-03-14,Cardiology,Seoul,550,27890,21244,1950.26,13394,1792,6646,14496
2024-03-15,Ophthalmology,Tokyo,272,16700,9366,2300.37,6718,1361,7334,9982
2024-03-16,Endocrinology,Chicago,752,41509,28065,5141.82,23875,3021,13444,17634
2024-03-17,Psychiatry,Chicago,853,47534,35466,2442.04,20058,3522,12068,27476
2024-03-18,Endocrinology,Tokyo,319,41766,22277,3125.67,14325,3670,19489,27441
2024-03-19,Ophthalmology,Berlin,737,31705,27043,2265.03,16309,2032,4662,15396
2024-03-20,Radiology,Houston,157,23787,19539,1833.52,9229,1567,4248,14558
2024-03-21,Endocrinology,Berlin,759,31588,22177,2361.39,14455,3039,9411,17133
2024-03-22,Emergency,Berlin,575,31123,27601,1750.75,15852,1643,3522,15271
2024-03-23,Pediatrics,London,555,38062,25391,3649.92,21698,2827,12671,16364
2024-03-24,Oncology,Los Angeles,928,15177,13562,1870.92,8160,1451,1615,7017
2024-03-25,Endocrinology,Tokyo,994,26727,20504,2957.96,13441,2152,6223,13286
2024-03-26,Gastroenterology,New York,460,35220,26551,4130.85,17747,2723,8669,17473
2024-03-27,Dermatology,Tokyo,100,14882,8428,864.87,8687,929,6454,6195
2024-03-28,Pathology,New York,486,6136,5232,890.63,2385,412,904,3751
2024-03-29,Cardiology,Seoul,447,39832,26727,5331.48,11962,3688,13105,27870
2024-03-30,Dermatology,Los Angeles,289,36966,20881,4824.4,14105,2881,16085,22861
2024-03-31,Pediatrics,London,604,12009,6065,1588.77,4387,909,5944,7622
2024-04-01,Ophthalmology,Sydney,290,17987,13020,2577.02,8967,988,4967,9020
2024-04-02,Psychiatry,Tokyo,607,42311,30081,4418.34,20737,2149,12230,21574
2024-04-03,Radiology,Sydney,468,36575,28811,2561.28,17484,3591,7764,19091
2024-04-04,Pathology,Tokyo,508,6007,5142,670.85,1831,413,865,4176
2024-04-05,Oncology,Tokyo,923,10445,5554,1298.19,5417,837,4891,5028
2024-04-06,Endocrinology,Toronto,216,15706,12448,1944.27,6236,847,3258,9470
2024-04-07,Pathology,Los Angeles,233,49486,28452,5054.74,24719,4164,21034,24767
2024-04-08,Urology,Tokyo,157,34257,28887,1947.37,15997,3310,5370,18260
2024-04-09,Dermatology,New York,655,26736,22127,2329.01,10769,2106,4609,15967
2024-04-10,Dermatology,London,784,47207,33815,6707.01,16067,2658,13392,31140
2024-04-11,Neurology,Chicago,771,18281,14334,1982.48,6002,1445,3947,12279
2024-04-12,General Surgery,Sydney,272,6435,4026,668.17,3535,568,2409,2900
2024-04-13,Endocrinology,Seoul,928,38339,26395,2947.71,22064,2696,11944,16275
2024-04-14,Ophthalmology,London,914,40150,33270,3486.82,19871,3773,6880,20279
2024-04-15,Pathology,Los Angeles,248,30821,21072,4300.6,10202,2540,9749,20619
2024-04-16,Neurology,Tokyo,179,31660,20361,3693.02,13316,3006,11299,18344
2024-04-17,Psychiatry,Los Angeles,985,10084,7035,1298.2,5230,818,3049,4854
2024-04-18,Gastroenterology,Houston,312,21661,18006,2067.21,11565,1225,3655,10096
2024-04-19,Ophthalmology,Tokyo,302,18507,11734,2091.75,6208,1211,6773,12299
2024-04-20,Dermatology,Sydney,863,12059,6867,902.48,3617,724,5192,8442
2024-04-21,Emergency,Tokyo,328,23271,18263,2805.23,11952,2221,5008,11319
2024-04-22,Psychiatry,Berlin,775,12491,10372,1158.67,5083,1099,2119,7408
2024-04-23,Ophthalmology,Los Angeles,326,19859,10728,1871.8,7473,1664,9131,12386
2024-04-24,Dermatology,Tokyo,758,13073,7790,1502.51,3972,850,5283,9101
2024-04-25,Pathology,Toronto,631,14077,7837,2021.85,6504,833,6240,7573
2024-04-26,Ophthalmology,London,540,25953,16588,1463.77,14412,2279,9365,11541
2024-04-27,Oncology,Houston,501,16383,11142,2170.33,9621,1207,5241,6762
2024-04-28,Gastroenterology,London,146,7353,5878,582.64,3453,450,1475,3900
2024-04-29,Psychiatry,Chicago,332,28821,21917,2720.47,13094,2329,6904,15727
2024-04-30,Pathology,Los Angeles,404,42567,31855,2221.63,13856,2214,10712,28711
2024-05-01,Pathology,Berlin,625,29860,19138,2391.92,13874,1979,10722,15986
2024-05-02,Orthopedics,Los Angeles,242,26195,21914,2626.39,10844,1923,4281,15351
2024-05-03,Endocrinology,Berlin,514,16939,11662,942.11,8166,972,5277,8773
2024-05-04,Pediatrics,Berlin,612,30338,27050,3006.79,12639,3010,3288,17699
2024-05-05,Psychiatry,Houston,472,26730,20145,3814.67,9945,1615,6585,16785
2024-05-06,Urology,London,665,26427,14548,1599.87,8680,1493,11879,17747
2024-05-07,Orthopedics,London,985,40196,30969,5082.55,15856,2418,9227,24340
2024-05-08,Endocrinology,Chicago,358,32083,20213,2918.5,10555,2837,11870,21528
2024-05-09,Endocrinology,Houston,755,26510,20532,3062.37,9359,1889,5978,17151
2024-05-10,Dermatology,Los Angeles,570,49064,25898,3730.02,29251,3840,23166,19813
2024-05-11,Pathology,Chicago,111,12813,7302,845.01,5550,654,5511,7263
2024-05-12,Urology,Toronto,429,36598,30826,2417.16,16819,1892,5772,19779
2024-05-13,Pediatrics,Houston,835,32570,19244,1858.09,18307,2354,13326,14263
2024-05-14,Orthopedics,Chicago,883,32082,26782,2199.69,19206,2914,5300,12876
2024-05-15,Pathology,Sydney,457,34241,20945,3986.4,16258,3227,13296,17983
2024-05-16,Radiology,Chicago,507,35678,27013,4929.6,19399,1938,8665,16279
2024-05-17,Gastroenterology,Los Angeles,767,49569,38547,6513.99,19732,3812,11022,29837
2024-05-18,Orthopedics,Chicago,472,16745,11806,1984.51,6559,1601,4939,10186
2024-05-19,Pediatrics,Seoul,107,31029,19303,1894.11,13057,2153,11726,17972
2024-05-20,Orthopedics,Seoul,221,18025,10545,1422.51,9044,1648,7480,8981
2024-05-21,General Surgery,Sydney,447,41124,21107,3330.25,20753,2331,20017,20371
2024-05-22,General Surgery,Sydney,775,19288,11989,1446.52,7610,1866,7299,11678
2024-05-23,Ophthalmology,Seoul,189,28650,21810,2907.99,9739,2508,6840,18911
2024-05-24,Dermatology,Sydney,747,11540,10101,1195.03,5651,1120,1439,5889
2024-05-25,Radiology,Sydney,797,37232,31590,3190.36,12602,3121,5642,24630
2024-05-26,Oncology,London,415,21422,17275,1828.99,10144,1460,4147,11278
2024-05-27,Oncology,London,277,8342,6801,1108.28,4237,808,1541,4105
2024-05-28,Pediatrics,Chicago,639,46846,35883,6039.82,23900,2987,10963,22946
2024-05-29,Emergency,Seoul,831,40612,24534,3280.62,21363,2705,16078,19249
2024-05-30,Gastroenterology,Los Angeles,968,15396,13284,2176.67,8650,1309,2112,6746
2024-05-31,Oncology,Seoul,140,22482,17272,3266.22,10116,1984,5210,12366
2024-06-01,Gastroenterology,Seoul,839,28411,20574,2348.86,14747,2740,7837,13664
2024-06-02,Pediatrics,Toronto,803,18261,9941,1560.27,8870,1100,8320,9391
2024-06-03,Radiology,Toronto,601,8093,5493,813.86,2881,727,2600,5212
2024-06-04,Emergency,Sydney,244,16722,11440,2409.84,5145,1453,5282,11577
2024-06-05,Emergency,New York,300,27042,22872,3721.84,10420,1438,4170,16622
2024-06-06,General Surgery,London,823,49413,35511,2977.47,21391,3427,13902,28022
2024-06-07,Dermatology,Berlin,560,33087,21578,2953.78,16051,2122,11509,17036
2024-06-08,Pathology,Los Angeles,831,37347,33265,3934.03,20727,2435,4082,16620
2024-06-09,Emergency,Toronto,851,38756,21094,3887.74,13908,3842,17662,24848
2024-06-10,Cardiology,Seoul,657,44214,29580,3067.85,14929,3631,14634,29285
2024-06-11,Pediatrics,Seoul,646,21335,11026,2899.04,12567,1832,10309,8768
2024-06-12,Psychiatry,New York,352,33602,26745,3954.76,11169,3320,6857,22433
2024-06-13,Emergency,New York,489,39450,34212,5278.05,17497,2716,5238,21953
2024-06-14,Emergency,London,693,37196,22764,5054.06,17692,3351,14432,19504
2024-06-15,Ophthalmology,Toronto,982,10626,8961,1326.5,4913,762,1665,5713
2024-06-16,Endocrinology,Los Angeles,355,12424,7664,1166.88,4047,1161,4760,8377
2024-06-17,Neurology,Los Angeles,808,17857,15433,1983.1,5662,1054,2424,12195
2024-06-18,Gastroenterology,Sydney,914,49923,40017,3296.74,16556,4861,9906,33367
2024-06-19,Cardiology,Sydney,549,24982,20534,2932.0,11883,1522,4448,13099
2024-06-20,Psychiatry,Berlin,109,16425,8330,1115.67,7609,1089,8095,8816
2024-06-21,Ophthalmology,Tokyo,923,6980,6178,833.38,2583,612,802,4397
2024-06-22,Endocrinology,Seoul,897,31431,24851,2293.2,15443,2190,6580,15988
2024-06-23,Neurology,Sydney,341,24440,15199,1509.3,13344,1965,9241,11096
2024-06-24,Emergency,Berlin,350,46752,38886,3110.34,14608,3376,7866,32144
2024-06-25,Pathology,New York,976,22175,13584,1113.17,9966,1931,8591,12209
2024-06-26,Cardiology,Seoul,104,31385,26649,3825.01,15905,1927,4736,15480
2024-06-27,General Surgery,Sydney,218,43158,23522,5318.8,16214,2284,19636,26944
2024-06-28,Orthopedics,Houston,900,28019,21896,2843.74,10992,1821,6123,17027
2024-06-29,Endocrinology,London,473,23639,16932,1563.4,11443,1742,6707,12196
2024-06-30,Emergency,Sydney,164,24994,13462,1458.54,14231,1459,11532,10763
2024-07-01,Psychiatry,Seoul,245,39375,23497,2044.07,21379,2667,15878,17996
2024-07-02,Ophthalmology,Berlin,323,26563,13413,1768.43,12615,1859,13150,13948
2024-07-03,Psychiatry,Chicago,338,44341,30484,6167.19,23015,2344,13857,21326
2024-07-04,Emergency,New York,276,10776,6686,799.08,4412,853,4090,6364
2024-07-05,Dermatology,Seoul,878,41444,30641,3540.44,20402,3904,10803,21042
2024-07-06,Gastroenterology,Los Angeles,952,8380,5186,507.28,3685,482,3194,4695
2024-07-07,Gastroenterology,London,381,13711,8500,990.43,4894,1095,5211,8817
2024-07-08,Dermatology,Los Angeles,162,13782,10988,1404.7,7036,1147,2794,6746
2024-07-09,Endocrinology,Berlin,316,22434,11649,2485.13,10475,1592,10785,11959
2024-07-10,Neurology,Chicago,953,25017,21543,1864.65,10196,2127,3474,14821
2024-07-11,Ophthalmology,New York,926,35707,30026,1991.49,20474,2518,5681,15233
2024-07-12,Pediatrics,Houston,894,44110,33837,3930.35,13510,3318,10273,30600
2024-07-13,Pathology,Seoul,788,22343,16473,1640.43,8819,1125,5870,13524
2024-07-14,Pediatrics,Seoul,560,43827,37556,3153.59,13895,3707,6271,29932
2024-07-15,Orthopedics,Berlin,709,46652,26784,6810.55,24723,3875,19868,21929
2024-07-16,Emergency,Berlin,204,10655,5664,1189.42,5440,553,4991,5215
2024-07-17,Pathology,Sydney,198,49859,29706,5269.49,19913,3410,20153,29946
2024-07-18,Cardiology,Chicago,610,20251,16561,1854.54,10180,2003,3690,10071
2024-07-19,Emergency,London,484,5526,2839,513.33,2314,392,2687,3212
2024-07-20,General Surgery,London,504,8224,6029,856.04,4333,617,2195,3891
2024-07-21,Urology,Toronto,922,16536,14852,1978.42,7213,1579,1684,9323
2024-07-22,Urology,Tokyo,617,33541,28250,4032.12,14210,2879,5291,19331
2024-07-23,Endocrinology,Tokyo,575,18547,13142,1245.79,10765,1467,5405,7782
2024-07-24,Emergency,London,808,39531,20771,3953.55,14834,3553,18760,24697
2024-07-25,Gastroenterology,Sydney,962,13712,11415,1250.48,4609,1278,2297,9103
2024-07-26,Oncology,New York,744,43565,32220,5970.7,20709,3173,11345,22856
2024-07-27,Psychiatry,London,969,14208,7757,1607.52,8394,1047,6451,5814
2024-07-28,Pathology,Los Angeles,870,10109,5434,1043.76,4178,700,4675,5931
2024-07-29,Ophthalmology,London,536,40201,34727,2473.95,12808,3953,5474,27393
2024-07-30,Oncology,Los Angeles,122,21967,16863,2428.75,8826,1864,5104,13141
2024-07-31,Neurology,Berlin,664,34759,28909,2145.34,15703,1882,5850,19056
2024-08-01,Dermatology,Tokyo,776,25172,21436,2107.42,8774,2344,3736,16398
2024-08-02,Cardiology,Toronto,813,41935,30558,2695.76,20859,3104,11377,21076
2024-08-03,Ophthalmology,Toronto,557,31589,22332,3765.64,18932,1688,9257,12657
2024-08-04,Emergency,Sydney,182,35015,23536,2472.94,15249,2713,11479,19766
2024-08-05,Neurology,Chicago,244,34009,21316,3033.12,13821,2409,12693,20188
2024-08-06,Neurology,London,184,22773,15345,3178.37,9569,2138,7428,13204
2024-08-07,Urology,Los Angeles,177,46125,37340,3248.66,15430,2776,8785,30695
2024-08-08,Cardiology,Sydney,556,31143,23069,3138.61,17595,2844,8074,13548
2024-08-09,Radiology,Chicago,977,11154,9559,1025.36,4734,868,1595,6420
2024-08-10,Urology,London,100,26804,18155,1388.78,11155,1413,8649,15649
2024-08-11,Emergency,Toronto,150,46688,34681,6035.63,23246,4603,12007,23442
2024-08-12,Oncology,Tokyo,784,25581,19250,1455.68,11066,1934,6331,14515
2024-08-13,Psychiatry,Chicago,816,35087,25847,3418.37,17349,2264,9240,17738
2024-08-14,Pathology,Sydney,871,37981,29665,4028.56,12094,2790,8316,25887
2024-08-15,Oncology,Los Angeles,545,8762,5213,988.73,4767,813,3549,3995
2024-08-16,Cardiology,Toronto,548,14768,10410,1755.37,8597,963,4358,6171
2024-08-17,Orthopedics,Berlin,980,48408,26222,3646.44,23944,2886,22186,24464
2024-08-18,Emergency,Tokyo,587,44499,29093,2269.35,26092,2512,15406,18407
2024-08-19,General Surgery,London,899,43559,30276,5329.2,15046,2826,13283,28513
2024-08-20,Pediatrics,Chicago,133,13783,10487,1427.45,6108,1226,3296,7675
2024-08-21,Pathology,Berlin,447,34781,30614,4647.15,16713,2559,4167,18068
2024-08-22,General Surgery,Los Angeles,194,35811,26509,4732.02,16993,2197,9302,18818
2024-08-23,General Surgery,Tokyo,171,40488,32286,5438.86,17022,2360,8202,23466
2024-08-24,Endocrinology,Berlin,650,13905,9768,1369.77,5581,926,4137,8324
2024-08-25,Ophthalmology,London,253,14127,10646,1177.67,4775,1370,3481,9352
2024-08-26,Emergency,New York,349,27431,14493,3542.87,11453,1842,12938,15978
2024-08-27,Orthopedics,London,773,11368,6840,1081.43,3965,1130,4528,7403
2024-08-28,Endocrinology,Toronto,537,32424,20905,2215.99,16870,2407,11519,15554
2024-08-29,Psychiatry,Chicago,217,23333,16076,3161.56,8461,1375,7257,14872
2024-08-30,Emergency,Houston,870,28116,14571,3887.21,8928,2658,13545,19188
2024-08-31,Orthopedics,London,990,48201,26800,4657.71,22447,3519,21401,25754
2024-09-01,Psychiatry,Seoul,405,20525,12535,1181.62,9822,1754,7990,10703
2024-09-02,Radiology,Houston,367,28398,25234,2521.25,15947,2816,3164,12451
2024-09-03,Pathology,Houston,153,37857,23946,4934.8,17909,1987,13911,19948
2024-09-04,Cardiology,Chicago,335,15361,10642,2153.27,6200,842,4719,9161
2024-09-05,Gastroenterology,Chicago,488,21369,12360,1503.25,11558,1838,9009,9811
2024-09-06,Dermatology,Los Angeles,833,8041,5985,455.9,3715,515,2056,4326
2024-09-07,Cardiology,Toronto,862,5105,3125,703.14,1652,302,1980,3453
2024-09-08,General Surgery,Los Angeles,924,14078,8204,1252.1,6613,731,5874,7465
2024-09-09,Pediatrics,Berlin,500,30003,21200,3125.6,17173,1532,8803,12830
2024-09-10,Urology,Berlin,723,11090,5569,1628.08,4645,983,5521,6445
2024-09-11,Radiology,Berlin,866,43850,22059,2484.39,17053,2487,21791,26797
2024-09-12,Endocrinology,New York,402,6925,4069,795.21,2375,508,2856,4550
2024-09-13,Urology,London,306,23440,12064,1345.7,8096,1882,11376,15344
2024-09-14,Cardiology,Sydney,328,44685,24273,3912.03,19207,3191,20412,25478
2024-09-15,Endocrinology,Chicago,952,31015,19711,4043.78,14847,1592,11304,16168
2024-09-16,Cardiology,Sydney,677,38320,31462,3577.07,12422,3417,6858,25898
2024-09-17,Pediatrics,Tokyo,174,30291,22076,4535.12,17625,1530,8215,12666
2024-09-18,Pediatrics,Chicago,534,41679,29386,4414.05,21945,3671,12293,19734
2024-09-19,Psychiatry,Chicago,202,31289,19317,2569.33,14893,2961,11972,16396
2024-09-20,Cardiology,Chicago,521,8389,7321,604.1,4601,601,1068,3788
2024-09-21,Neurology,Sydney,803,30683,20214,2609.65,9943,2355,10469,20740
2024-09-22,Oncology,Chicago,863,18629,9963,1625.44,8253,1375,8666,10376
2024-09-23,Pediatrics,Seoul,837,29826,22274,1696.25,14585,2071,7552,15241
2024-09-24,Oncology,New York,905,40198,21929,3495.51,22052,3793,18269,18146
2024-09-25,Pathology,Tokyo,405,31630,20182,3049.89,16923,2995,11448,14707
2024-09-26,Urology,London,197,38226,26871,4674.04,14645,2553,11355,23581
